сюлонь	myv
вольпасьын	kpv
туялысьлы	kpv
курскоень	myv
кӧнтусь	kpv
todistuksensa	fin
пойпанго	myv
крезьгуръёсыз	udm
korrigeerimiseks	est
чойяс	kpv
кедьчелькензэ	myv
katara	fin
автономиянь	myv
селекционер	udm
кечӹял	mrj
остaткa	mrj
петявксонть	myv
понӧляинъясӧ	kpv
кулэмъёсты	udm
ошкы	mrj
пирявксонть	myv
варышпиян	kpv
elämänasenteella	fin
браганок	myv
йӹлмӹштӹм	mrj
пусъёсты	udm
майоръясӧн	kpv
алопень	myv
maksudest	est
mammutil	est
animatsiooni	est
уясь	udm
пилён	udm
patsutus	est
lähetyskenttä	fin
makkaranpaloja	fin
служамодо	myv
йылпумъяськем	udm
натурализмын	mrj
laekal	est
рубрикаöн	kpv
кенере	myv
тугсӧ	kpv
депоын	udm
азаргадома	myv
государственной	myv
ямаквлäштӹ	mrj
конӧ	kpv
kinnik	est
паччöр	kpv
vinüülil	est
лембстэ	myv
газет-журналъясӧ	kpv
курез	udm
липа	kpv
kärsa	est
амал	udm
kaukomatkat	fin
virtuoosi	est
сцена	udm
консерваторим	mrj
театрвлӓн	mrj
surmatyötä	fin
жандармъяслӧн	kpv
sormitukset	fin
korjuu	fin
улэмзэ	udm
уполномоченной	myv
роза	kpv
архантьыл	mrj
вомынысь	kpv
бассейнэзлэн	udm
областьлы	udm
пекстамка	myv
аравтыця	myv
peitlit	est
гожпусъёс	udm
casanova	fin
satamajäänmurtaja	fin
agarikust	est
villal	est
воськов	kpv
стипендияяс	kpv
ленинизмъя	udm
грузчикӧн	kpv
катарышты	mrj
tõestamist	est
шыжар	mrj
бигеръёслы	udm
городок	myv
opintoviikkoja	fin
konformist	est
ноября	myv
чарлаöн	kpv
аслыссикаслунъяс	kpv
раштыцят	myv
тамарин	udm
шымымаш	mrj
kilpailuhenkisyys	fin
rattijuopon	fin
степь	kpv
профтехучилище	udm
морга	myv
дояркалы	kpv
relativismiga	est
spektaakkeleja	fin
атаслэн	udm
aktivistidega	est
verorästejä	fin
асывнас	kpv
oksennuspallot	fin
каштордома	myv
klarnetist	est
maagiale	est
вевттьöд	kpv
asumisen	fin
mõisted	est
сталмонть	myv
juhtumused	est
сельхозартель	udm
kohdunrungon	fin
айморт	kpv
кушка	myv
rapurutolla	fin
уроквлӓштӹ	mrj
квадрат	kpv
примеркс	myv
ковернэнь	myv
аргекӹн	mrj
теманок	myv
плитаяс	kpv
uuspakanuus	fin
социализм	mrj
коллективӹн	mrj
pritsme	est
puuvaja	fin
призыв	myv
monopoli	est
котъя	udm
пророклӧн	kpv
келейгавтома	myv
hänilast	est
кыстӥськеменыз	udm
арестантвлӓ	mrj
тӓпнӓквлӓштӹ	mrj
koulunäytelmissä	fin
кадколастö	kpv
бугыльыс	kpv
lumevaikutusta	fin
юстиция	udm
latvavesiin	fin
korrashoiuga	est
лаштыквлӓ	mrj
märkmikud	est
varjunditega	est
продюсер	kpv
muistis	est
темаосты	udm
matkata	est
героиня	myv
germanismide	est
кубызъёс	udm
loorberite	est
loppuraporttiin	fin
ботужвелесэ	myv
сайним	kpv
põlastusega	est
сюлмаськонэныз	udm
himmentimenä	fin
ränkus	est
джоджын	kpv
вӹдӱшкӱж	mrj
mörssäri	fin
физикасо	myv
урöс	kpv
viikkokausiksi	fin
reservaatissa	fin
ediktides	est
йырсaул	mrj
improvisaatorina	est
эпосын	mrj
фиалка	mrj
akordionil	est
бадь	udm
калмез	udm
кoлхoз	udm
lammutused	est
disaineritega	est
ateroskleroosi	est
площадка	mrj
киномеханик	udm
putru	est
концентраци	mrj
шаг	kpv
боеприпасым	mrj
публицист	myv
пыдыртымаш	mrj
настоятельлöн	kpv
sekovarsi	fin
паксян	myv
jakelukanavalla	fin
motiveeritus	est
канат	myv
кодексыс	kpv
текень	myv
топоним	kpv
порт	udm
философиштӹ	mrj
шукшвлӓн	mrj
айловӧн	kpv
осёлъяс	kpv
вирзэс	udm
счасияв	myv
шабердӥ	udm
koostamisel	est
kirikutele	est
ӧчередьӧн	kpv
пленумвлӓштӹ	mrj
veronhuojennus	fin
tuvikesed	est
экспертиза	udm
обелисксӧ	kpv
ласта	kpv
пузырнес	myv
саевкс	myv
прессазылы	udm
tiglitsa	est
jugoslaavit	fin
nahkatehtaan	fin
järvikaislaa	fin
позтырас	kpv
vivuista	fin
будон	udm
sovitteluyritys	fin
osseettia	fin
bingo	est
keskieurooppalaisesta	fin
otsonikatoa	fin
перм	udm
kopolymeereiksi	fin
япон	udm
шанымашвлӓ	mrj
puumailaa	fin
sortimenti	est
нюрмульы	udm
lainarahoituksesta	fin
садъёсын	udm
кушъёс	udm
содкс	myv
jumin	est
мотивъёс	udm
кооперативвлӓн	mrj
станциясо	myv
bestsellerite	est
таштамо	myv
самолётонть	myv
пухке	myv
наследиясонзо	myv
tilannearvioidensa	fin
ӹнянӹмӓшӹн	mrj
передача	kpv
plastsuse	est
punaisten	fin
начко	myv
inventaarioiden	fin
ывлаыс	kpv
легенда	udm
maanpuolustuksessa	fin
lyoni	est
мудерлуныд	kpv
оштнэнь	myv
koljut	est
кристиана	kpv
волан	mrj
юморым	mrj
kaklemine	est
оригиналышты	mrj
узерень	myv
ковылкинань	myv
нимтулэн	udm
пелька	myv
siloga	est
полосаез	udm
suojavärinsä	fin
enkaustika	est
чавка	myv
руцят	myv
арин	mrj
троспӧртэмлык	udm
хрестоматия	kpv
анжыктымашвлӓ	mrj
яраос	udm
harakiriks	est
паллян	udm
sekvestri	est
эшъяськон	udm
яд	udm
mahtitekijä	fin
сулэз	udm
кресьтянинлӧн	kpv
горда	kpv
об	kpv
прявтост	myv
вӧрӧгӧс	kpv
kärsimyshistoria	fin
лелькуйтчанкывъяс	kpv
fordil	est
профессия	kpv
газ	kpv
столӧвӧй	kpv
конденсатор	udm
viranhaltijansa	fin
porvarillisuuden	fin
sisäkulmiin	fin
эскерись	udm
синонимъяс	kpv
ёзэтсэ	udm
ципакат	myv
ожгаръя	udm
шӧм	udm
лексикологизылы	udm
чот	mrj
гозъя	kpv
меельцетнесэ	myv
петнявкст	myv
алкоголь	mrj
чаг	udm
ryhmiensä	fin
ӹнянӹдӹмӓш	mrj
hermafrodiidiks	est
велень	myv
электричкаос	udm
älykkyystasolla	fin
ямаксы	mrj
рудаяс	kpv
срокез	udm
пристань	myv
канава	mrj
kogumikega	est
kultusel	est
лекцияяс	kpv
edutusest	est
кызвынсӧ	kpv
massamurhia	fin
мелодия	kpv
курсышты	mrj
hukkunutele	est
крепостез	udm
ковтысас	kpv
адаптацим	mrj
футуризмӹн	mrj
жанржы	mrj
assimilatsiooni	est
пропуск	mrj
живописень	myv
рана	myv
вишкӹр	mrj
кассета	myv
райкомонь	myv
полксо	myv
чибӧ	kpv
piirdeks	est
лoэш	mrj
нäлмäш	mrj
юпик	mrj
паникудов	myv
lõrinat	est
ревматизм	mrj
валсюлмавкстонть	myv
вывтасінъяс	kpv
внучкаыс	kpv
дурбасьтӥсьёс	udm
kurkuma	fin
пынзалтышым	mrj
muutuvuses	est
sataan	fin
орожиямот	myv
кияксонтень	myv
taksilentoja	fin
зарнилöн	kpv
вискын	kpv
инфoрмацим	mrj
саваланер	mrj
энергетика	kpv
hiilihappoa	fin
югыт	udm
есаулокс	myv
кебит	udm
пейделька	myv
фондонтень	myv
agnostitsismi	est
historianfilosofiaa	fin
сонимакы	mrj
кагак	mrj
трудодень	kpv
поленӓ	mrj
скрипкаен	udm
lumenkaatopaikka	fin
память	myv
kõigutamatus	est
лач	kpv
экзаменъёссэ	udm
работник	mrj
уколым	mrj
вузан	udm
востым	kpv
brõnsaga	est
пор	mrj
чылкытлык	udm
epiteeti	est
kaliumoksidia	fin
kiertoajat	fin
кальсыяскӧд	kpv
совадо	myv
гуманист	mrj
тылшукш	mrj
deemoneid	est
naapureille	fin
эмъясьёслэн	udm
heite	est
слудаясысь	kpv
гуртоослэн	udm
muulukas	est
lämmittämiseksi	fin
termiidi	est
satama-altaan	fin
киномеханикыскöд	kpv
ӹлӹзы	mrj
шорезлэсь	udm
mutkamäenlaskua	fin
paimentolaisiin	fin
katosi	fin
быдэсъян	udm
piketile	est
чирдэм	udm
молот	mrj
метрика	kpv
цер	mrj
пӹтäрӹмäш	mrj
алясь	myv
simsalabim	fin
топонимика	udm
alapuoliskoon	fin
klavikordidel	est
kaje	fin
народ	kpv
буксир	kpv
тырмеменыз	udm
пӹжӓшӹм	mrj
selätykseksi	fin
спас	mrj
интернетлэн	udm
аваломанень	myv
кайсы	udm
борддораз	udm
päätösehdotus	fin
лайнер	kpv
кӓтӹквлӓ	mrj
интернетэнь	myv
студия	udm
moppi	fin
вел	mrj
вага	myv
кайпиныслӧн	kpv
кылдонэз	udm
teldritele	est
велинесэ	myv
imažismi	est
психиатр	mrj
починкаын	udm
титан	mrj
олас	kpv
бор	myv
прозалань	kpv
сёрмадоманзо	myv
гурысьтызы	udm
utmise	est
miilitsasse	est
rasvasuse	est
vaseks	est
akvakultuuri	est
tuneesia	est
медсестралысь	kpv
улостодос	udm
piiraita	fin
биржа	udm
узырилы	udm
колыс	udm
akordid	est
луншöр	kpv
jäljendajaid	est
von	kpv
архимед	myv
алютик	mrj
синонимень	myv
здоровье	udm
teisipäevast	est
sümbolistidega	est
finn	kpv
критикуйымаш	mrj
palsasoilla	fin
rikin	fin
удмурт	udm
туриствлӓ	mrj
лöдзьяс	kpv
hätäpuhelu	fin
ӝытлэн	udm
ӓкӓк-шыжарак	mrj
дискым	mrj
ам	mrj
казначей	kpv
ковёр	kpv
плотинӓм	mrj
творчествое	udm
äärilaidoilta	fin
лӧчкӓванды	mrj
гижӧдторъяс	kpv
шырым	mrj
ismiin	fin
геологиясӧ	kpv
полк	mrj
аквариум	mrj
seemisnahast	est
кузпалэныз	udm
autoradioista	fin
raakuutta	fin
казакъяс	kpv
конференциос	udm
peräruiskeet	fin
теоретик	myv
мырк	udm
passiivi	est
пырон	udm
taruolentojen	fin
ужмаш	mrj
орави	mrj
кельсодыцясь	myv
гым-чардыс	kpv
аппаратӧ	kpv
soitimen	fin
suorakaiteine	fin
коньывуон	udm
латиница	mrj
корпус	mrj
viisakusest	est
kaalikääryleitä	fin
заседаништӹ	mrj
чама	myv
hedelmäpelien	fin
dialektiikasta	fin
bentseenirenkaaseen	fin
tsunamit	est
продукция	udm
кадриль	udm
азинскемзэ	udm
брошюраяс	kpv
ӓмӹрт	mrj
валён	udm
рамат	myv
пансионатвлӓ	mrj
анжалмаш	mrj
sotilaslentokoneet	fin
сорс	kpv
сиякал	myv
tennishallit	fin
пачкатэм	udm
преподавательжӹ	mrj
урам	udm
поймасо	myv
гладь	kpv
кресьянъёслэн	udm
epidermofüütia	est
ямдарымаш	mrj
сёлтамонзо	myv
пейдемань	myv
tatikutest	est
гыбед	udm
ареал	udm
остров	mrj
кияр	udm
карксамос	myv
цирк	myv
кылдэт	udm
отделэнь	myv
дальней	myv
посёлыкысен	udm
дискотекаяс	kpv
nimiösivullaan	fin
koroneridel	est
зэръяс	kpv
kuolintodistuksen	fin
саваӧн	kpv
лескс	myv
мызы	mrj
tieto-opiksi	fin
таджик	kpv
makeisissa	fin
марьи	mrj
сержантлы	kpv
герб	kpv
собственность	mrj
talvisäiden	fin
maailmanmestaruuskisoissa	fin
физика	mrj
кӹцӹзӹ	mrj
vääringusse	est
оймеежосо	myv
айымашвлӓм	mrj
губерништӹ	mrj
педагогикань	myv
човорямо	myv
definition	fin
композицин	mrj
purjehtijoille	fin
администрациос	udm
вотӧдз	kpv
перке	mrj
кельсодый	myv
сталень	myv
soluseinä	fin
uteen	fin
heraldik	est
ассистент	kpv
tenoriavainta	fin
академияез	udm
alkudrinkki	fin
фамилизэ	udm
геройвлӓ	mrj
комакъёс	udm
памфлетвлӓ	mrj
сявадовксов	myv
patoloogi	est
югыд	kpv
нук	kpv
докладвлä	mrj
государӧдз	kpv
дунтэк	udm
вузасьысьӧс	kpv
слöнъясöс	kpv
мугоркультурая	udm
интеллигентвлӓ	mrj
инязорот	myv
велосипедэн	udm
ensikosketus	fin
мирыс	kpv
masurka	est
удмуртлык	udm
сирӹшӹвлӓ	mrj
heitteillepanon	fin
amneesiaga	est
keskusvaalilautakunta	fin
hämarikuga	est
асфальтым	mrj
геноцид	myv
välilihan	fin
реформа	kpv
pestitsiididega	est
вуйжырнервлӓ	mrj
мадмашвлӓ	mrj
eksponeerimisele	est
лексемаст	myv
гуртысьтыз	udm
бакчаосты	udm
despotismia	fin
кычылтмаш	mrj
poimukellomörsky	fin
цемент	mrj
aganad	est
хром	myv
плас	mrj
taudinkantajana	fin
куль	myv
фамилиятне	myv
пудо-животэз	udm
penny	fin
йӧны	udm
валнэде	myv
сэтӧр	kpv
plommi	est
пикскеть	myv
лингвист	udm
liikevoitoltaan	fin
войвывлӧн	kpv
lataajia	fin
лӱдӹшвлӓ	mrj
väävel	est
riisist	est
вайгельпеть	myv
bafia	fin
мыйыкъёссэ	udm
irlanninsammal	fin
bioloogile	est
ушъяськем	udm
вöлмытонъя	udm
ритмань	myv
balloonile	est
piittaamattomuudesta	fin
uraaniatomit	fin
kapusiinit	fin
вельтявкссо	myv
джек	kpv
баба	kpv
арыслан	udm
мотик	udm
зоологияысь	kpv
нярбордйöн	kpv
адрес	udm
tšuvašši	est
юлтошъёсы	udm
кежест	myv
каганат	myv
ӓкӹм	mrj
качонь	myv
fosfori	fin
ӵашъем	udm
kaunidust	est
лада	udm
указ	mrj
нинкӧмсӧ	kpv
ньӧлъёслэсь	udm
юрмег	udm
пехотинец	kpv
kraade	est
компенсацим	mrj
метелцӓ	mrj
нӧш	kpv
valitsemisessa	fin
карнеде	myv
maakerrosta	fin
кывторъясöн	kpv
чукӧ	kpv
duos	est
миянь	myv
бригадир	mrj
ытва	kpv
февраль	kpv
grusiinlased	est
покольнеть	myv
ын	udm
журналистъёслэн	udm
чукыляс	kpv
hietikoilla	fin
сiмöн	kpv
jõukatsumiseks	est
toenditega	est
барлак	myv
gerontoloogia	est
rautatieliikenteessä	fin
курсякс	myv
статьяослэн	udm
медалень	myv
томбамот	myv
syntymäpaikalla	fin
стильжӹ	mrj
navigaatoritest	est
sensoreille	fin
лапужа	myv
двор	myv
авторъёсыз	udm
адӟонъёс	udm
пызырымашлан	mrj
лӱтеранвлӓ	mrj
шундыӝужанысен	udm
куакаез	udm
мероприятивлäм	mrj
карпас	kpv
сказка	udm
плотина	myv
ветлӥсь	udm
alkusoittoja	fin
голець	myv
täiel	est
керӧссянь	kpv
башкиръёс	udm
чукыръясыс	kpv
животъёслэн	udm
парашютонть	myv
келтӹмашвлӓм	mrj
чапка	myv
алганьчей	myv
материалтнэ	myv
säteilysairauden	fin
rait	est
randaaliga	est
качествоез	udm
патькыш	mrj
lutte	est
толкеш	mrj
приборъёс	udm
sopimuskumppanin	fin
keerutamine	est
региононь	myv
proteesi	est
динар	myv
войнаяс	kpv
валамзы	udm
водзöс	kpv
ӓви	mrj
lõivude	est
чӧд	kpv
karavaanilla	fin
бурдъёссэ	udm
мӧскӓ	mrj
шӧдонэз	udm
limiitidest	est
выйӧ	kpv
keittoastiat	fin
препарат	kpv
juhiste	est
ӟырдатэм	udm
полкс	myv
etujoukko	fin
соловей	myv
kilpailusuoritusta	fin
помидор	mrj
keräilyllä	fin
юренькай	kpv
песьтэрзэ	udm
muromlasi	est
картукыш	mrj
курныгучкыж	mrj
индустрия	kpv
чара	myv
аскост	kpv
hallintotuomioistuimet	fin
коршт	myv
лыдакывъяс	kpv
лӓктӹшӹм	mrj
галя	kpv
чесноков	myv
капитанъёсты	udm
tesaurus	est
шева	kpv
фараон	myv
talousneuvoston	fin
кама	udm
luolakoiralla	fin
pyörintänopeutta	fin
etteastumine	est
операцивлäштӹм	mrj
подвалеш	mrj
kioskööri	est
asemointia	fin
одарсо	myv
horisontaali	est
läbivuse	est
мордвавлӓ	mrj
объёмось	myv
provokaatioksi	fin
jääkuutio	fin
лулосъёс	udm
ӓштӹмӓш	mrj
joulusauna	fin
epävapaata	fin
чань	kpv
зап	kpv
фольклорен	udm
социалистэнь	myv
kääreen	fin
karkelot	fin
кын	mrj
мелодиянтень	myv
гипербола	myv
канцтонь	myv
быдтэмез	udm
сессия	kpv
fjordides	est
типографияö	kpv
экзаменъяссö	kpv
изъян	udm
маршрутъяс	kpv
вичкоӧ	kpv
королевства	myv
судышты	mrj
политбюроезлэн	udm
директоре	udm
парьнеть	myv
puolivarjoon	fin
льыртык	mrj
историк	kpv
акань	kpv
уроконть	myv
помшуöмъяс	kpv
жeпӹм	mrj
mamille	fin
лев	mrj
условиясо	myv
monoloogi	est
учительской	myv
häirintälähetin	fin
юла	mrj
силем	udm
майӧг	kpv
дукъя	udm
surivoodil	est
радиопередачаос	udm
pointillisti	fin
проулка	mrj
бызьылон	udm
басьтэмын	udm
viskatsoja	fin
pullamössön	fin
анисовкатне	myv
водь	udm
харт	mrj
цӓнгӓвыч	mrj
алаша	mrj
коськема	myv
konfirmatsiooni	est
вӹдкыва	mrj
ан	kpv
pakistani	est
kuma	kpv
моренвлӓн	mrj
вырем	udm
sisseveetud	est
йидіяс	kpv
ministerinsalkut	fin
сентября	myv
ӓзӓ	mrj
retoorikat	est
пристань	kpv
mahategemist	est
моментвлӓ	mrj
мельванома	myv
professionaalsuse	est
фольклорист	myv
бензинсэ	myv
сценариензэ	myv
мӓкш	mrj
исследователь	myv
lähikonda	est
psüühikale	est
верькстнэ	myv
тшыглунысь	kpv
зоопарксо	myv
промышленность	mrj
лейчирень	myv
vaatekaapista	fin
depešš	est
aгрeсси	mrj
uhhaa	est
lukumuistia	fin
лӹпӹвлӓн	mrj
уксноманзо	myv
ыргон	udm
rantideta	est
куличвлӓ	mrj
кысконъя	udm
эпидемия	kpv
литературоведэсь	myv
projektipäällikkö	fin
punnis	est
салтомадо	myv
информаци	udm
феврале	udm
lapsityövoimaa	fin
баян	mrj
lurjuksista	fin
рецензия	myv
mestariehdokas	fin
кӧртулов	kpv
curlingin	fin
комиссиен	udm
заводвлӓштӹ	mrj
салдыркс	myv
käräjäsaliin	fin
кырыкышты	mrj
лавка	udm
от	kpv
huik	est
кек	kpv
halpuutensa	fin
облигацият	myv
etääntymisnopeuden	fin
ӧтемезъя	udm
поень	myv
папирус	mrj
kameruni	est
taasiseseisvumist	est
семпанго	myv
ымныр	udm
vasteajat	fin
материкез	udm
вискö	kpv
кудъяс	kpv
улонниос	udm
grossil	est
лымшор-шундыпуксён	udm
nahkru	est
peegeldused	est
чузъяськемез	udm
kümnenditeks	est
monsuuni-ilmasto	fin
термин	udm
пиосмуртлэн	udm
нимкылъёслэн	udm
пророклэн	udm
konjektuur	est
komando	est
вӧлонлы	udm
haahla	fin
кӧстыль	kpv
цынга	mrj
фрегат	mrj
сойӧн	kpv
асфальтонь	myv
достижения	myv
йöзкост	kpv
шӹльӹ	mrj
maneežiga	est
произведениеяс	kpv
дия	myv
редакциянзо	myv
туберкулез	mrj
vastamine	est
telttaa	fin
diptühhonist	est
йӓнгӓршуды	mrj
sefiir	est
ривезькесь	myv
kolmikul	est
деликатесеш	mrj
ökonoomikas	est
прядомадонзо	myv
organiseeritus	est
kaivosinsinööri	fin
sõõrmed	est
аддзӧмторъяс	kpv
karttaliitteessä	fin
дзоль	kpv
näitur	est
телевидениелöн	kpv
kvargile	est
ломыжыш	mrj
teenistusse	est
пӧртэмлыксэ	udm
панжовксонзо	myv
kontingendiga	est
defektoloogia	est
kirkkoveneet	fin
санаторивлӓштӹ	mrj
ainuõõssete	est
историк	mrj
аристократ	mrj
гожъяськисьёслэн	udm
промолэн	udm
грамотат	myv
езъёс	udm
puhelinkeskusteluille	fin
kirjutatust	est
самшудывлӓ	mrj
купечъёслэсь	udm
poeedil	est
кӹшкӹмäш	mrj
krääsästä	fin
игот	mrj
parkkiaineet	fin
шӧрвӓ	mrj
lõugamiseks	est
лирика	mrj
тыманавлӓ	mrj
метрат	myv
сравненият	myv
браунинг	udm
кирине	myv
rupsi	est
brošüüri	est
носорог	udm
статистика	udm
кызьлэсь	udm
пассажирвлӓм	mrj
куймест	myv
инженер	kpv
пӹрӹнзӹквлä	mrj
каток	mrj
syveneminen	fin
asuinalueena	fin
aitosuomalaisia	fin
grafomaania	est
инициаторжы	mrj
парквлӓштӹ	mrj
апрель	mrj
азораваст	myv
tekstinselityksen	fin
ääntämyksessään	fin
половецтнэнь	myv
ryyppäjäisten	fin
пенсионеръяс	kpv
ролест	myv
меленӓвлӓм	mrj
avovaunuja	fin
чернигань	myv
йирмöг	kpv
колоз	myv
vägistest	est
вочыгачым	mrj
танстензэ	myv
кугуза	mrj
эрмитажлэн	udm
лисеманзо	myv
фольклорист	udm
газ	udm
brüoloogia	est
пограничникъяс	kpv
virtakisko	fin
raamatukesena	est
просвещени	mrj
генералэз	udm
нупоньчей	myv
кафедраеныз	udm
лямблиятне	myv
публицистика	mrj
путешественниклӧн	kpv
тантейкатьнень	myv
sümboolikal	est
narmad	est
трудицятнень	myv
матрос	mrj
рись	myv
myymäläapulaisella	fin
лабораторижӹм	mrj
каргуртсы	udm
отряд	kpv
hullumeelse	est
лили	mrj
буйвол	mrj
академикӧн	kpv
паром	udm
карсӧ	kpv
баскетболэз	udm
kadakatega	est
санаториясь	myv
азӥсь	udm
silmäkokoja	fin
kofaktori	fin
toonikaa	fin
ventovieraan	fin
касса	udm
šuaanid	est
доллареш	mrj
panssarintorjunta	fin
колхоз	udm
lakeiks	est
шӹгӓ	mrj
кӧзапиӧс	kpv
классик	mrj
prinsessalle	fin
баяр	kpv
mõistetavuse	est
пӓшӓлӹмӓшӹшкӹжӹ	mrj
тундра	myv
дефектологиянь	myv
коса	kpv
synkroniaa	fin
изоляторвлäм	mrj
leivonen	fin
комедилэн	udm
pidennyksineen	fin
konstia	fin
heetin	fin
juhtumitele	est
teoretiseeringuks	est
alaruumiin	fin
ньылпу	udm
автомашина	kpv
торгоца	mrj
кампет	kpv
ropo	fin
картаос	udm
лимон	udm
гопе	udm
järeldusi	est
цӓрлӓнгӹн	mrj
puunia	est
шайыл	mrj
чужтö	kpv
torikauppaa	fin
ранаясысь	kpv
družinnikuid	est
blanketis	est
кабанъяс	kpv
isyyslomaa	fin
adõgee	est
jumestus	est
лаксы	mrj
полигонъяс	kpv
шайтан	udm
поттонэз	udm
администрацияö	kpv
ёкмыльӧй	kpv
karjete	est
rikkumatuse	est
ovulatsiooniga	est
кавалеръяс	kpv
лыкын	mrj
фикус	mrj
тшакъяс	kpv
arbuuside	est
курӧгъясыс	kpv
коллекция	kpv
предание	kpv
кужмоятонлы	udm
skeptisyyteen	fin
араб	udm
moraalisääntöihin	fin
valekarettikilpikonna	fin
pleegitus	est
правительстволӧн	kpv
pääjoukko	fin
убоосын	udm
мальпигияяс	kpv
degenerant	est
tsunftidesse	est
поздйысьӧм	kpv
ыдылмаш	mrj
керасъясын	kpv
киросысь	udm
нижней	myv
рис	myv
описанивлӓштӹ	mrj
бесермян	udm
тешъяс	kpv
кодкӧд	kpv
тутманзо	myv
киштиця	myv
йылолъёсызлы	udm
õelus	est
ӓнгӹремшӹм	mrj
pystyasennon	fin
куала	udm
sydänpuu	fin
тарьксэв	myv
вочасöн	kpv
балет	mrj
изданиш	mrj
haavand	est
мокшот	myv
suojakeleillä	fin
центнер	mrj
regioonidele	est
редакци	mrj
нылашез	udm
maitseroheline	est
шаявлӓм	mrj
результат	mrj
яндаваст	myv
аски	kpv
энялдоманзо	myv
олысьясӧн	kpv
vaktsineeritutest	est
чалмыт	udm
теологи	mrj
пирамида	mrj
копас	myv
tattarin	fin
телефон	mrj
биолог	udm
hehkuviiniä	fin
säynettä	fin
семетнень	myv
атмосфера	mrj
образонзо	myv
экваторöдзыс	kpv
груша	mrj
делегатэз	udm
лыдъян	udm
кӧмеч	udm
видъёссэ	udm
казах	kpv
ловпу	kpv
dialekti	est
кӹцкӹвлӓжӹ	mrj
heeliumile	est
малярияысь	kpv
soojakutes	est
drops	est
väylänä	fin
урьваля	myv
trummideta	est
planetaariumis	est
заданивлӓм	mrj
символикаен	udm
хорват	udm
luokanvalvoja	fin
таган	mrj
мастерскӧйын	kpv
пичень	myv
monstrumi	est
петшöрысь	kpv
tähtipelaajia	fin
бастионвлӓ	mrj
päringule	est
лыкмашышты	mrj
карштымашым	mrj
hypogonadismista	fin
шуонъёс	udm
усадьбаос	udm
тетрaдь	mrj
пилич	kpv
радъёс	udm
метротрам	udm
арлан	mrj
хӹрхӓ	mrj
корректорокс	myv
наместничестволэн	udm
intendandina	est
шолвонгы	mrj
меельсэ	myv
safiirist	est
ломе	udm
ruohomaat	fin
kattumuseks	est
махачкала	myv
sisäänmarssia	fin
буддизм	kpv
ravustuskautena	fin
veetšed	est
petatavuihin	fin
вӹдъялышкы	mrj
джаз	myv
sypressipuista	fin
oikeusasioita	fin
чияпу	udm
предприятивлӓштӹ	mrj
фирма	udm
talletuspankkeja	fin
улаз	udm
прос	mrj
murrekirjailija	fin
асыв-лунвыв	kpv
варым	mrj
минут	kpv
codex	fin
шолыштмаш	mrj
сотрудник	udm
тематика	myv
концертмейстер	kpv
symmetriatasojen	fin
машинаосты	udm
kõhetumine	est
бербаöн	kpv
virkavirheestä	fin
юрист	udm
литератор	kpv
hevoskuljetuksiin	fin
veikka	fin
варыш	mrj
parasiitti	fin
суйӧр	kpv
монополим	mrj
плодъяс	kpv
продукци	mrj
республика	mrj
легенда	mrj
бажамось	myv
жар	kpv
чапавтома	myv
скрипка	kpv
физкультурая	udm
партиез	udm
олимпиада	mrj
мыскылымашым	mrj
rannikkolaivastolle	fin
гобелентнэнь	myv
kehitysyhtiö	fin
kobakad	est
чирекс	myv
докторлысь	kpv
jar	kpv
воджын	kpv
alleshoidmine	est
чурамо	myv
galvanometrilla	fin
рыт-войӧ	kpv
покштят	myv
ohitustietä	fin
кӹрӹш	mrj
лира	mrj
кенерепакарьс	myv
панамаын	udm
нарва	udm
пособие	udm
ortopeedi	est
колодкакӧд	kpv
картаö	kpv
migrantide	est
автомашина	udm
turkista	fin
surelikkusele	est
fee	est
лэч	kpv
älypeli	fin
тӥямын	udm
pesemisestä	fin
нига	kpv
hüperesteesia	est
кунжутым	mrj
конкурсын	udm
viitoseksi	fin
kylmäkiskoisuuden	fin
скобкаясын	kpv
чикордыця	myv
valailta	fin
eramutes	est
варзи	udm
ярманга	kpv
ютыръяс	kpv
лю	kpv
быгатонлыкезлы	udm
бассейнлысь	kpv
декабре	udm
царамак	mrj
округось	myv
цӹрцӹк	mrj
paistes	est
шукконъя	udm
vauhdikkuudestaan	fin
лавгамо	myv
тарантасэзлэн	udm
мактась	udm
грива	myv
сири	mrj
туризмез	udm
тубатаз	udm
salateksti	fin
бесерманъёсты	udm
шыпичаӧс	kpv
kola	est
amfora	est
лысваын	kpv
материк	mrj
сӹлнештӓрӹмӓш	mrj
пӹсмӓнӹш	mrj
могильник	udm
monijumalaisuus	fin
сенаторын	mrj
труба	udm
музейсö	kpv
тӧварышъяс	kpv
аранжировщик	udm
okulaariin	fin
дискуссивлӓ	mrj
esivaaleihin	fin
почодома	myv
pelikortteja	fin
воз	kpv
минусышты	mrj
антоним	mrj
нужвлӓн	mrj
ассамблейӹштӹ	mrj
kuumutamise	est
monoksidista	fin
икшӹвӹштӹ	mrj
lõikudelt	est
eläinravinto	fin
abin	fin
glaukoniit	est
колеса	kpv
письмöяс	kpv
норовжорчось	myv
радиокомитетын	kpv
talaari	est
пластъясыс	kpv
ежӹнг	mrj
kenttävarustuksia	fin
самолётсэ	udm
vaihtamisesta	fin
кион	udm
шкатнень	myv
промышленностень	myv
морынеть	myv
пунктъяс	kpv
riiska	est
suoritusajoista	fin
пармы	mrj
kiini	est
jahmatusest	est
teeliseks	est
посводзас	kpv
saabastest	est
virtuaalitodellisuudessa	fin
лудкечез	udm
черодэн	udm
окульця	myv
deliiriumi	est
турын	udm
vorme	est
социализм	kpv
viljavalmisteista	fin
епархи	mrj
поселениелэн	udm
лейнесь	myv
интернэт	myv
hihnaa	fin
korilusega	est
рöдиналы	kpv
туризм	kpv
шиэдалмашыш	mrj
кадама	mrj
sahaus	fin
kiginata	est
кавалер	myv
налог	kpv
hõivatust	est
ульмамо	myv
кырмаш	mrj
пöкатöдз	kpv
сюлмавксонь	myv
аспирант	myv
тылпу	udm
трансгаз	kpv
orkestratsioonile	est
traplaste	est
йöла	kpv
растениянь	myv
питомникӹм	mrj
тырдаз	myv
якут	udm
нардечи	myv
патерез	udm
кычымашым	mrj
nutid	est
поттӥсез	udm
taarale	est
философия	kpv
путыця	myv
зверь	mrj
марксизм-ленинизмлэн	udm
täiturit	est
кайышыштым	mrj
sotse	est
аванок	myv
макинтошын	mrj
товт	myv
наречие	udm
драмтеатрын	kpv
riitteineen	fin
klausuulia	fin
plutooniumiga	est
lupiinista	fin
koorel	est
kronometreihin	fin
агрономия	myv
äädikas	est
riista-alueille	fin
мешере	udm
enammakstud	est
anglikaani	est
зиль	kpv
фaктвлӓ	mrj
учительница	myv
preferenssinsä	fin
кыле	udm
яв	myv
горсоветаз	udm
флора	mrj
отрядын	mrj
ышмашкы	mrj
промышленниклэн	udm
искусствасо	myv
охотник	mrj
каръяськем	udm
хозяйствоын	udm
гудöкöн	kpv
фламинго	udm
шайыштмашвлажӹм	mrj
vesijohtovettä	fin
дивизин	mrj
lähihoitajaksi	fin
гожтосэн	udm
finesse	est
вӹрзи	mrj
oppimäärään	fin
ялаксось	myv
kruiisideks	est
кулялопат	myv
шӓкшӓльӹвлӓн	mrj
часонь	myv
haarakonttorin	fin
артистка	mrj
подшипникъёсты	udm
косӧдінысь	kpv
авине	myv
mummu	est
форматэн	udm
vanhentumista	fin
карел	mrj
tummanpuhuva	fin
шкамо	myv
kansalliskiihkoa	fin
kaappikello	fin
aardest	est
рестамонзо	myv
каньлы	kpv
озксонзо	myv
saarestikul	est
биологи	udm
tahkosi	fin
драматурги	mrj
уйт	kpv
konverterini	est
поручени	mrj
talonpoikaissäädyn	fin
степень	myv
водород	mrj
тӓнгвлӓ	mrj
орикс	udm
който	kpv
седямопель	myv
ремонтжы	mrj
конкурсышты	mrj
поколени	mrj
радлун	kpv
собраниелöн	kpv
täring	est
пежетензэ	myv
венгръёс	udm
pildistusi	est
sosiaaliministerin	fin
kotiarestin	fin
дед	udm
orientaation	fin
кризис	mrj
кардинал	mrj
квартираез	udm
эрлень	myv
дагестан	udm
локомотив	udm
скверъясын	kpv
akronüümiga	est
лехакс	myv
позициштӹм	mrj
лабораториез	udm
дыдыке	udm
пурьгинекев	myv
ruustinna	fin
кошкем	udm
карензэ	myv
väljendamist	est
теоретиквлӓ	mrj
muinaisuskontoja	fin
поезд	mrj
нарды	udm
palkollistensa	fin
korraldamisest	est
koriste-esine	fin
вуюись	udm
лемтэй	udm
мыктешкӹвлӓн	mrj
virrenveisuu	fin
joonel	est
деятель	myv
вӓпшвлӓ	mrj
кеккомбы	mrj
университетын	udm
losangelesilaisen	fin
lingvaal	est
kärpäsiltä	fin
sortamista	fin
sepiku	est
декрет	mrj
лугинесь	myv
конструкторлэн	udm
студишты	mrj
filmi	est
саесь	myv
pugejana	est
кучнеманть	myv
närkästyksen	fin
серга	myv
musketär	est
referendumini	est
капитанось	myv
горкомезлэн	udm
hematologian	fin
книгинеть	myv
пуд	udm
краеведениелӧн	kpv
säppi	fin
купеч	kpv
кӓдӹвлӓн	mrj
кибашлы	udm
енэжъяс	kpv
категория	myv
инструктор	myv
веськӧдлысьпуӧн	kpv
шимшӓдӓнгӹ	mrj
kvantiteetin	fin
filmindus	est
авторитетӹм	mrj
земляквлӓжӹ	mrj
коммунар	myv
важвлӓжӹм	mrj
selkoteksti	fin
kesäpuuhun	fin
веранъёсы	udm
kaarisulkeiden	fin
arabistikat	est
sõgelased	est
ummiku	est
briise	est
тырмытон	udm
берыктэмен	udm
комфортым	mrj
katkestamised	est
eha	est
курок	myv
кунянъёсты	udm
намер	udm
институтнэнь	myv
быгатэменыз	udm
fenoolil	est
spasmista	fin
ӹжӹвӹр	mrj
системалэн	udm
результат	kpv
таргань	myv
džomolungma	est
ljaano	est
мартын	kpv
sekstetist	est
поход	kpv
пропорциосын	udm
mainonnasta	fin
йыды	udm
выльгурт	udm
флаглэн	udm
ладямодо	myv
учебникӹм	mrj
leikkelemakkaroihin	fin
оймавтыця	myv
стенӓвлӓжӹм	mrj
abstraheerituse	est
tiilenpunaiselta	fin
бизнесӹм	mrj
ватонэз	udm
maalauksessaan	fin
сценкаосыз	udm
юртъерзэ	udm
korraldamatuse	est
kambrikauden	fin
registreerunust	est
шервлӓм	mrj
калийöн	kpv
таджик	udm
eroanomuksensa	fin
майор	myv
avaari	est
тувокал	myv
широтаосын	udm
динамитöн	kpv
ӓйӹк	mrj
valmiusaste	fin
luolamaalauksiin	fin
asiakaskäyntejä	fin
тиражез	udm
huilunsoittoa	fin
ilad	kpv
alipäällikköä	fin
sotilasjohto	fin
солдатка	myv
keskiarvoon	fin
пидеманть	myv
субӧта	kpv
kahvia	fin
депутатпуӧн	kpv
сям-йылолъёсынызы	udm
кальтнень	myv
изумруд	mrj
обеспечениея	udm
маякышты	mrj
пиш	mrj
sintoismi	est
нора	myv
видзöдлас	kpv
volli	est
пацине	myv
портретэнзэ	myv
цемент	kpv
пермякъёслы	udm
sprotid	est
тун	kpv
kuljettimia	fin
muminaa	fin
kogudusel	est
intervention	fin
ritari-ihanteet	fin
ryhdikkyys	fin
кевкстемат	myv
пораткашты	mrj
кузя	kpv
neutraalsusel	est
угоддьö	kpv
маръямоль	kpv
геодезист	mrj
heres	est
фараонын	mrj
parallelogramm	est
политиквлӓ	mrj
filtriga	est
seiväshyppääjä	fin
дискотекасо	myv
тӧняяс	kpv
кредит	kpv
kolibrit	fin
синтаксисӹштӹм	mrj
gwitšin	fin
лыкиця	myv
капитуляция	kpv
коронань	myv
tüübel	est
теориезъя	udm
инфинитив	kpv
pops	est
дымбыр	udm
opetussuunnitelmiin	fin
районӧн	kpv
seipillä	fin
летчиквлӓлӓн	mrj
раск	kpv
пачказы	udm
юнга	mrj
психологи	mrj
kliente	est
musiikkilukio	fin
кыртъясыс	kpv
статус	mrj
тшыкӧдысь	kpv
poonud	est
вулкан	mrj
лымныв	kpv
телевизор	kpv
hyrrä	fin
adventi	est
greifi	est
лыддьӧгас	kpv
dreeni	est
filipiinlastel	est
annaale	est
suojauksella	fin
пырам	udm
асыввывса	kpv
paikallisaika	fin
vakuutusehtojen	fin
йод	kpv
воргаас	kpv
доцент	mrj
торпингесь	myv
abstraktsust	est
цитнимасо	myv
genitaalid	est
сӱан	mrj
стрелок	mrj
чемпионатонть	myv
чассянь	kpv
техника	mrj
паркын	kpv
budapesti	est
filmifestivaaleista	fin
гордсин	udm
специальносьтъяс	kpv
резервъя	udm
приискъёс	udm
käsitsijuhtimisega	est
laulujuhlista	fin
merijärveläiset	fin
ассоциация	udm
йäнгӹн	mrj
плато	mrj
тöдöмлунъяс	kpv
sümfooniate	est
водителе	udm
гигант	mrj
мойдкывъяс	kpv
авиакомпания	udm
кусь	myv
пöчö	kpv
судын	kpv
ягодной	myv
risteyttämisestä	fin
канавава	myv
kübaras	est
avaaja	fin
аран	mrj
коллоэцвлӓн	mrj
спортö	kpv
промышленниквлӓн	mrj
peruslukuun	fin
лоштямодо	myv
шайт	kpv
bensooliga	est
ilmattaren	fin
ты	udm
патераясын	kpv
myyntiedustajat	fin
merinorsuja	fin
пумра	myv
шамак-ямак	mrj
доходвлä	mrj
вывтасыд	kpv
тулыспал	udm
атайзы	udm
степендиянть	myv
реклама	mrj
персиштӹ	mrj
ppm	fin
dollarit	est
самыньжым	mrj
сюл	udm
площадь	kpv
тшöть	kpv
куслянть	myv
kirjohylje	fin
кидысэн	udm
keskenmenoon	fin
кыйёсты	udm
сывельямдо	myv
кварталъяс	kpv
painonnostajia	fin
jäkäläkankaat	fin
вожвылъяськонын	udm
пластмассань	myv
видь	myv
агентствоосын	udm
янга	myv
прогрессэнь	myv
тӓрзӹ	mrj
слугажы	mrj
afaasiaga	est
äraandmisest	est
мера	kpv
комсомолось	myv
лапкорлысь	kpv
tentsik	est
hantista	fin
вурс	mrj
отар	mrj
отличи	mrj
сям	kpv
пропаганда	mrj
колантор	kpv
стряпиця	myv
тундраын	kpv
тропа	myv
ботаникышты	mrj
амаш	mrj
чарынь	myv
пинь	udm
иглас	myv
будэтон	udm
um	kpv
верӓш	mrj
borease	est
кандыловось	myv
шимпанзе	udm
сир	udm
aikajaksot	fin
elajad	est
näppi	fin
korki	est
йыръёсыз	udm
pirujen	fin
sutti	est
контрреволюци	mrj
лыпшвлӓ	mrj
средствояс	kpv
дозъяс	kpv
гаж	kpv
oksake	est
августэ	udm
etäsukukielissä	fin
информациянть	myv
татарка	myv
седицят	myv
kattumine	est
нарви	kpv
чокмор	udm
mähis	est
рӓдӹвлӓ	mrj
сёрникузяяс	kpv
карнан	kpv
шӱлӹвлӓн	mrj
чӧвлун	kpv
merikilpikonnia	fin
сквер	udm
liittymiseensä	fin
чокыр	kpv
ордер	myv
liikennemelu	fin
сорокатнень	myv
публицистикая	udm
благодарностень	myv
сямлунсӧ	kpv
скульптурат	myv
ӝутэ	udm
чавоманзо	myv
энергия	udm
график	mrj
романэз	udm
тшӧтшкӧс	kpv
garnisonil	est
улонысьтыз	udm
тонна	udm
stuupor	est
фотографияясӧн	kpv
лексика	mrj
канонь	myv
modulointina	fin
пештясь	myv
топыдлун	kpv
kolopesijä	fin
plioseenikauden	fin
kalastusalue	fin
хоккей	mrj
рeфoрмaци	mrj
natsionalism	est
эмъяськонниын	udm
полковникекс	myv
ородышуды	mrj
чанстеть	myv
ӓтӹдерӹм	mrj
vesikauhu	fin
интернационал	udm
книгапоттонниысь	udm
ӹлӹшвлӓ	mrj
стандартокс	myv
personaalia	est
псаломым	mrj
messia	est
segasust	est
tietoviisas	fin
камера	kpv
пучӧйясӧс	kpv
h-hetkeä	fin
скульптoрвлӓ	mrj
kalastuskunta	fin
puolustusase	fin
seinäkiipeilyä	fin
byby	kpv
обкомезлэн	udm
лириканть	myv
пиемазонзо	myv
ванькске	myv
карпо	kpv
küüni	est
власть	kpv
тан	myv
больницясто	myv
мариця	myv
biskviit	est
маразь	myv
valangutele	est
коткудавонь	myv
aйыртeмвлӓжӹ	mrj
пивтема	myv
будосъёсты	udm
жанранть	myv
prestiiži	est
пятилетка	udm
целензэ	myv
luhankalaisia	fin
rikesakkoja	fin
гранитэнь	myv
кывсикасъяс	kpv
пер	udm
asianajajansa	fin
pommitajatega	est
ужа	myv
карьерын	kpv
банк	mrj
государствомы	udm
качайяс	kpv
пиядо	myv
гира	kpv
графика	mrj
кадръёслэн	udm
суткинас	kpv
трубкажы	mrj
соксто	myv
чай	kpv
manöövris	est
репутациштӹм	mrj
patrullidel	est
оппозицилäн	mrj
корзинӹм	mrj
кирдить	myv
homos	est
экспертъёслэн	udm
burkad	est
пыдул	udm
ӧтуволанінысь	kpv
копия	kpv
парсын	mrj
инъяс	kpv
baltlus	est
kuitukimpun	fin
tahtest	est
emfüseemi	est
кыжвек	mrj
vetoomuksista	fin
сюрса	kpv
гос	kpv
kollokviume	est
кылдышвлӓ	mrj
дивизионын	udm
репортажъёсыныз	udm
vesillelaskun	fin
вылльӧв	kpv
мавзолейын	udm
пӹл	mrj
sanitari	est
вуджасас	kpv
продукт	udm
кaтоликвлӓ	mrj
sinkkaus	fin
вукыремъёслэсь	udm
ыбылӥськонэз	udm
aseidenriisunnassa	fin
правописание	kpv
орнитологи	mrj
секретaрьжы	mrj
природоведениез	udm
мастер	myv
pidustustel	est
kevätistuntokausi	fin
ӝытазе	udm
ломаютко	myv
etioloogiat	est
тӹшкер	mrj
мерькавиця	myv
nurmik	est
ведьулыне	myv
шрифтсэ	myv
keskiluokan	fin
tjumeni	est
пистть	myv
malagassi	est
нырис	kpv
kaupadega	est
тӧнгӹлвлӓ	mrj
физалис	udm
бугыръянын	udm
külvist	est
таксиос	udm
vaikutuksina	fin
образецъёс	udm
гондыр	udm
ladustamisest	est
плетонвлӓ	mrj
араукария	udm
тайымаш	mrj
трубатне	myv
ylimystölle	fin
tööline	est
тантейчидензэ	myv
хирургияя	udm
левӓш	mrj
гордбыжлэн	udm
толшораз	udm
ваниль	myv
тьӧт	kpv
pretsedendi	est
мунё	udm
ronki	est
ӟольгыри	udm
esityskiellosta	fin
аръёсаз	udm
кышкыттэмлыкъя	udm
кöч	kpv
татараяс	kpv
телес	myv
фестивале	udm
вор	udm
баллада	kpv
пызь	udm
партышым	mrj
интыянъя	udm
евангелим	mrj
опереттазэ	udm
антитеза	mrj
командатнесэ	myv
феодал	kpv
yksityisomaisuus	fin
poliisiviranomaisiin	fin
tammikuu	fin
фронтъёсын	udm
совнарком	udm
шӹдӹр	mrj
куштэм	udm
организацивлäлäн	mrj
setäänsä	fin
заповедниклӧн	kpv
грамота	mrj
saavutamist	est
гербсэ	myv
аз	kpv
tšetšeenidele	est
тырмытэмын	udm
филологъёс	udm
капитан	mrj
пучыосыз	udm
para	kpv
кузьта	kpv
konföderatsiooni	est
kemoteraapia	est
roolil	est
интернационал	mrj
фабрикаос	udm
сибиряк	udm
мoда	mrj
вестэ	myv
балян	udm
сьöктöдö	kpv
polügaamia	est
bulgaarlasele	est
кыркöтшъясысь	kpv
вальс	mrj
консультацилэн	udm
каванямка	myv
шаршавт	myv
туроквлӓм	mrj
silmävammat	fin
изимӧр	mrj
хозанлык	mrj
авар	udm
gekot	fin
medrese	est
vibratsioonide	est
джынйöн	kpv
лилия	udm
ihmiselon	fin
сёртас	kpv
оскат	myv
ментол	myv
kiistapallolla	fin
жердя	myv
князь	kpv
удалцетне	myv
elvytystoimet	fin
чулькъяс	kpv
таркатнева	myv
füüsikat	est
лацеманзо	myv
paarilised	est
декорациятнень	myv
toissapäivänä	fin
поль	kpv
ilmestymisaikanaan	fin
батöг	kpv
sigadusega	est
lossides	est
eteläsaamen	fin
penikkataudin	fin
tehottomuutensa	fin
хими	mrj
magistriteks	est
экспансижӹ	mrj
ber	kpv
гиббон	udm
vastandumisel	est
ятыр	udm
шундыез	udm
pientareilla	fin
валемын	udm
округ	mrj
эпитетъяслӧн	kpv
norra	est
сёйтӧг	kpv
ӧркӹ	mrj
totuttelusta	fin
mõeldavuse	est
зӧкталаез	udm
neutroniga	est
luottamuksellisuus	fin
savusilleihin	fin
ожмаськись	udm
singliks	est
кизьӧртор	kpv
pediaatrite	est
latvus	fin
alasis	est
маршъёс	udm
linja-autovuoroja	fin
вашпижмаш	mrj
morfologista	fin
карас	mrj
техник	myv
гуманизм	mrj
maalaisliittolaiset	fin
гимнастика	kpv
ум	udm
товсюро	myv
кискатнеде	myv
suuska	est
атлас	myv
медик	udm
тесьтсӧ	kpv
планировказэ	udm
нинпу	kpv
калоньчистэ	myv
сьöлаясöс	kpv
проулка	mrj
полюсöдз	kpv
käks	est
управляющӧйӧн	kpv
footonist	est
уджъёртъяскӧд	kpv
резиденци	mrj
миф	kpv
филологи	udm
шал-шал	udm
улоланго	myv
dispetšeri	est
probiootit	fin
вежава	myv
hääbumine	est
lausumisest	est
шужгымашым	mrj
mielitaudit	fin
порода	mrj
арцтсо	myv
скорпионвлӓ	mrj
kiangissa	fin
riivistamiseks	est
бӧрӧздаяс	kpv
наволо	myv
болгар	udm
куартолэзе	udm
морко	mrj
прӧща	kpv
apologeet	est
ижъёс	udm
шорсюлэмзэ	udm
телеграфистӧн	kpv
rajalinjat	fin
огазеямын	udm
seurakoira	fin
пиземечирьке	myv
камералэсь	udm
куное	udm
мыжырангмаш	mrj
герб	mrj
пропаганда	kpv
колибривлӓн	mrj
эдемлäн	mrj
ворттылонъя	udm
kesytystä	fin
юртнэнь	myv
ettevõtluses	est
отставкае	udm
хирургъёслэн	udm
озяскеть	myv
марксизмъя	udm
збойлун	kpv
yhtiöjärjestyksen	fin
пиземень	myv
помещиктнень	myv
гачьяс	kpv
пелемат	myv
гожтонлы	udm
корреспондент	udm
шог	kpv
квадрат	udm
katolisuus	fin
kirjastuseks	est
murha-aseen	fin
бабушкаяс	kpv
алнэнзэ	myv
звернеде	myv
sepelvaltimotaudissa	fin
нолдамосо	myv
группаязы	udm
куяртикшень	myv
fulani	fin
кагак	mrj
vaihtokurssein	fin
утёнэз	udm
alttoviulujen	fin
процесс	udm
sattumanvaraisuus	fin
kuunkierron	fin
professuuriks	est
хутор	udm
imettäminen	fin
вырт	mrj
кснавне	myv
рекламаен	udm
ivas	est
lumivyöryjä	fin
портфельӹштӹ	mrj
täysjäsenenä	fin
традицивлӓжӹ	mrj
торосост	myv
jääkiekkokoulua	fin
alkukodistaan	fin
одямо	myv
эскеронэз	udm
территориосыз	udm
varjatus	est
панда	udm
лайшематнень	myv
вельксэнь	myv
панзей	myv
taksidermistina	est
kansallislauluista	fin
мартен	udm
valjastega	est
ümbertegemine	est
эртӓрӹмӓш	mrj
obligatsioone	est
сэстонъя	udm
лавр	udm
пӧськы	udm
leirielämästä	fin
пуалтмаш	mrj
псалмвлӓ	mrj
karedusena	est
наркоматсо	myv
пыӵаз	udm
südikus	est
шылдырвлӓн	mrj
loojangut	est
лымы	udm
ӧртӹм	mrj
majandit	est
обложка	myv
витаöн	kpv
vankreid	est
ювелирӹн	mrj
уездэнь	myv
апостолтнэнь	myv
сэльге	myv
пропорциятне	myv
swingiin	fin
манямкантень	myv
кудазоро	myv
ынгылыдымашым	mrj
лаймева	myv
рекорд	udm
мӹжӓр	mrj
тылгӱ	mrj
monstrants	est
имниэшкӹ	mrj
куашкам	udm
августонь	myv
juhla-ateriaan	fin
гожъян	udm
нянь-сов	kpv
küllastunuks	est
бланка	myv
йишвлӓш	mrj
господь	myv
прозаикъёс	udm
аслобетъёс	udm
аноксокс	myv
padrik	est
экваторысь	udm
kunniavieraat	fin
дед	kpv
гозы	udm
ускиця	myv
вирява	myv
пародияяс	kpv
elefantiaas	est
eliksiirien	fin
грексӧ	kpv
мӧйы	udm
printsiipides	est
laivueessa	fin
seurojentalon	fin
пӱкшӹм	mrj
палата	kpv
верöс	kpv
кали	kpv
космополит	mrj
лембеёнксонь	myv
spondeused	est
керемӹм	mrj
словарь	kpv
yhdenmukaistajia	fin
глаголъёсты	udm
тодосчилэсь	udm
аптека	udm
кечӹвуй	mrj
нарьгамотнеде	myv
пӧдругасӧ	kpv
turkmeeni	est
кандидатт	myv
кекшема	myv
улмопу	udm
кактусъяс	kpv
группань	myv
иржаня	myv
прессын	mrj
takapyörien	fin
pohjoissuomalainen	fin
mosasaurus	est
станоквлӓм	mrj
органзы	udm
каргамын	udm
автобиографи	mrj
чипы	udm
keemikuna	est
басня	kpv
штельксстэ	myv
чавканӧс	kpv
чевть	myv
salbutamolia	fin
jäljendus	est
кондициштӹм	mrj
aliohjelmista	fin
нуллон	udm
быдöн	kpv
гран	kpv
постын	udm
гижыосыз	udm
премьер-министржы	mrj
кöртöн	kpv
каземанть	myv
vuorovedeksi	fin
материалвлӓжӹ	mrj
карпвлӓн	mrj
парад	mrj
эргӓшвлӓлӓн	mrj
kubismia	fin
аромат	mrj
miliisin	fin
кисьтэм	udm
паразит	mrj
muutumiseks	est
vanadel	est
чиркъясӧс	kpv
бюроезлэн	udm
aloittelijan	fin
цӹлдӹр	mrj
пекля	kpv
marseljeesi	fin
діясын	kpv
riekaleet	fin
кивалтон	udm
депутатвлӓ	mrj
вомкӧтш	kpv
mielenterveysongelmat	fin
аслан	mrj
кубометр	kpv
spartalased	est
рехеньвлӓ	mrj
лым-зэрва	kpv
практиканзо	myv
ӱнгӹвлӓ	mrj
пуктэмъя	udm
baki	est
роколма	mrj
лездыцясь	myv
автобус	mrj
pizzicato	fin
качмаш	mrj
визулöн	kpv
калмолангонь	myv
баркасъяс	kpv
экипажкӧд	kpv
johdinautoa	fin
diktorina	est
сюконямо	myv
монографим	mrj
isobaare	est
kibestus	est
чавачамо	myv
lehvikute	est
снайпер	myv
ina	kpv
том	myv
kunstidele	est
pateeni	fin
яратӥсез	udm
токарьёсын	udm
тӱтӱтвлӓ	mrj
висьтас	kpv
вӧвлытӧмтор	kpv
neuralgia	est
hiussuonia	fin
качыжы	mrj
васолкст	myv
вирьпуло	myv
лезгин	udm
puolivokaali	fin
вераме	udm
metsästyshaukkojen	fin
корреспондентэкс	myv
ципирькаень	myv
ошкеть	myv
электроэнергиянь	myv
серпасасьӧм	kpv
кыпышы	mrj
словенэнь	myv
kordumatuses	est
чинӧ	kpv
arterioskleroos	est
картинжӹ	mrj
стихъяс	kpv
soru	est
sahhariin	est
arkiaskareet	fin
maissipuuro	fin
kommutatsiooni	est
siidrid	est
градус	mrj
ялгатне	myv
библиотекаын	kpv
командованижӹн	mrj
кидӹш	mrj
ушнымашым	mrj
муш	mrj
panttivankeja	fin
горниповнекс	myv
uskonnottomalle	fin
лузь	udm
казематыш	mrj
jälgimisest	est
казензэ	myv
historiograafia	est
изнямодо	myv
попал	myv
työpäiviä	fin
курсӧ	kpv
ситӓрӹмӓш	mrj
циан	myv
edustuse	est
педсоветсэ	myv
частьышты	mrj
magmapesäkkeiden	fin
патриотвлӓн	mrj
фотографият	myv
kehätuomarin	fin
polüetüleeni	est
hoovi	est
eilispäivän	fin
пармаысь	kpv
рифма	mrj
рамаясыс	kpv
ӧсъёссэ	udm
кунва	kpv
каталог	myv
пыласькем	udm
illatiiv	est
барышня	kpv
hašiš	est
пумаш	mrj
syyrialaiset	fin
ортсӧ	kpv
учредителез	udm
rõhujatest	est
люк	kpv
lobe	est
келейгадомадо	myv
ӧткалун	kpv
санэз	udm
илэв	myv
пöкйыс	kpv
ongströmi	est
целковойть	myv
tatuoinnin	fin
ног	kpv
barrikaadi	est
чеснӧк	kpv
sisäänhengitystä	fin
öтсяма	kpv
кершень	myv
nälänhätien	fin
säärikarvat	fin
спортзал	udm
чиявтома	myv
manksin	fin
кукшыгечӹшкӹ	mrj
dokumenttielokuvaa	fin
туркмен	udm
банлы	udm
эскеремез	udm
lõpmatus	est
чемпионкаез	udm
шушырвлӓм	mrj
komplikatsioonidesse	est
versoille	fin
джыджъяс	kpv
стройкатнес	myv
выжонэн	udm
тiльгун	kpv
turvattiin	fin
ruhv	est
rakuks	est
ooperil	est
арсенал	udm
jerevani	est
изделивлӓм	mrj
нюжаез	udm
rekisterikilpeä	fin
ӧжын	kpv
декабря	myv
выжыосын	udm
olympialaisina	fin
tsüstide	est
senttimetrejä	fin
утисьёс	udm
kaootilisusele	est
чапамонь	myv
diskvalifikatsioon	est
атасгурӟон	udm
kaskaadid	est
äraviimises	est
зэмзэ	udm
ситцӹ	mrj
пашкаржы	mrj
портэм	udm
джианъяс	kpv
степъяс	kpv
сильди	mrj
падкагыль	mrj
секта	mrj
puutumatusega	est
saarmastele	est
osoitus	fin
maimiku	est
вӧлмон	udm
угыёпу	udm
кылдытонэ	udm
обрядонь	myv
lauakesest	est
вӓрӹш	mrj
haani	est
сормасянь	kpv
полавтомась	myv
лангозонзо	myv
napatähti	fin
господа	kpv
alkeiden	fin
нылпи	udm
sanatooriumis	est
ноябре	udm
стенокардия	myv
huippuarvon	fin
rytmitajunsa	fin
леднемась	myv
реактор	mrj
дитя	kpv
рокöн	kpv
июль	udm
неркӓ	mrj
liekkiä	fin
ужчиосты	udm
молемат	myv
нингуби	udm
агитацим	mrj
минимум	mrj
tegelikkusega	est
televisiokamera	fin
миж	mrj
пунктир	mrj
ӵыжы-выжыез	udm
итӹн	mrj
нопйӧн	kpv
кларион	udm
стипенди	mrj
мунямонь	myv
гагъясӧс	kpv
лобӟемзэс	udm
kellalööjana	est
мэн	mrj
голяас	kpv
дружба	myv
пуляос	udm
крестьяна	kpv
роднякс	myv
ёндолокс	myv
кашарварня	mrj
kuorekalojen	fin
быдмӧм-сӧвмӧм	kpv
кöдзыдъяс	kpv
sivuliikkeen	fin
ёмавтыцясь	myv
фарватерзэ	udm
ньывкайясӧс	kpv
событиос	udm
heliotroop	est
стеклö	kpv
жанръяслы	kpv
мизолксось	myv
пекничаӧ	kpv
бомбуйымашеш	mrj
vander	est
мартонок	myv
keefir	est
геройёслы	udm
прусси	mrj
uusintaesityksissä	fin
бырöдö	kpv
йыдалым	mrj
юатэк	udm
шарды	mrj
tullisuoja	fin
охырецӹм	mrj
большевиквлӓ	mrj
паськöмсö	kpv
бичасез	udm
polarisatsiooniga	est
ыстэмын	udm
собранньӧ	kpv
kaksikamarijärjestelmään	fin
magalat	est
калгосто	myv
пуктӥськонлэн	udm
kinaveri	est
кӹвервлӓ	mrj
мойдъяс	kpv
покордамот	myv
дозъяс	kpv
болгар	myv
янгылымашым	mrj
tähekesega	est
экипажось	myv
nominalisteihin	fin
hyppyhäntäisiin	fin
проeктвлӓн	mrj
пак	kpv
ikonografia	fin
maranad	est
паксясараз	myv
вейсхозсо	myv
конвейер	udm
чапаксто	myv
труппаез	udm
pistemääräänsä	fin
моко	udm
лыдышвлӓэш	mrj
eteläslaavilainen	fin
мера	myv
mango	est
зэхель	myv
унжат	myv
krimi	est
pankkilainalla	fin
выльдӥськонъёсты	udm
снартнемат	myv
куги	mrj
опытсӧ	kpv
lenkkeily	fin
правилоос	udm
тынг	mrj
уйнить	myv
вез	kpv
innustajaid	est
веркыдсянь	kpv
avangardismini	est
пӧчыс	kpv
падежсэ	myv
кырымпасъяссӧ	kpv
кавшта	mrj
kyrmyniskoiksi	fin
ресурсъяс	kpv
подпиская	udm
ӓнгӓлтӹш	mrj
loodeteks	est
сосновкань	myv
лэбӧ	kpv
em	kpv
dainad	est
строямонь	myv
сервизӹн	mrj
tulenliekkejä	fin
лауреат	kpv
peilisalissa	fin
universaalista	fin
дöскаö	kpv
сырьксэнь	myv
argumentides	est
концернышты	mrj
asetamisel	est
методикая	udm
leegionäre	est
выльдырцанвлӓ	mrj
луньын	kpv
комик	udm
magnetismin	fin
спорт	myv
pianokappaleen	fin
ворсӧ	kpv
озысь	kpv
кыльы	udm
elanikele	est
жугыльлун	kpv
kevytmetalleiksi	fin
ӝуасьнумыр	udm
демонстраци	mrj
танкистӧн	kpv
обласьтлы	kpv
бриллиантвлӓм	mrj
kaatopaikoilla	fin
juutalaisespanja	fin
петровка	myv
пӹлгомышты	mrj
лыса	kpv
оляксчинь	myv
честь	kpv
tšuvašši	est
вокъяс	kpv
идеалвлӓштӹ	mrj
рудзӧгысь	kpv
müeliit	est
transpositsioone	est
paidelased	est
автомат	kpv
тонавтыцятне	myv
чита	kpv
suuliekki	fin
kruunasi	fin
ветеринар	mrj
possaadnik	est
цӓрӓгапшангы	mrj
yritysasiakasta	fin
геологи	mrj
tuohitöistä	fin
suurentelusta	fin
мастумарь	myv
televisioyhtiöt	fin
историысьтыз	udm
sivistyneistö	fin
tagasivallutamine	est
пужымъёс	udm
pientaloasunnoissa	fin
сыречинзэ	myv
ylistäjä	fin
кошель	myv
vaivalloisuus	fin
spektroskoobiga	est
льнозавод	udm
охоницӓ	mrj
pähkinänkuoressa	fin
malmiga	est
polünoomid	est
araablanna	est
pettäjä	fin
ruokalistaan	fin
transparentidel	est
kompvekkide	est
килькшкезэст	myv
кушманзэ	udm
га	kpv
arus	est
unifitseerimise	est
таргоземат	myv
шляпадо	myv
kirkonrakentaja	fin
tunnollisuuden	fin
käenkaali	fin
глаголвлӓн	mrj
тӹвӹлӓйӹмӓш	mrj
koolibrilased	est
nõgi	est
эшкема	myv
стихотворение	kpv
eksitusega	est
айы	udm
теоривлӓжӹ	mrj
нудеень	myv
наукаысь	kpv
кивоштӥсез	udm
комедивлӓм	mrj
дворецын	udm
гитараӧн	kpv
ydinpelote	fin
приказ	myv
brändidel	est
содавиксэть	myv
вӧвъясöс	kpv
пож	kpv
okkultisti	fin
чинал	myv
lüürikat	est
йӹргецвлӓ	mrj
rankaisu	fin
черкес	udm
крокодил	kpv
monsuuniin	fin
пусъён	udm
altruistista	fin
luonteistaan	fin
образ	udm
сирень	mrj
пыдыргывлӓ	mrj
батареяыс	kpv
тылаяс	kpv
gyroskooppeihin	fin
порсьöс	kpv
misäärin	fin
kahvliga	est
valokopiokoneita	fin
туливить	udm
умарькс	myv
hääaterian	fin
haittasi	fin
куректонэз	udm
шагыртем	mrj
пузлаын	kpv
спискӹштӹ	mrj
баӵкоосты	udm
ыжлюгы	udm
huippukunnossa	fin
pürotehnik	est
trubaduureista	fin
полавтневиця	myv
сизь	kpv
tsement	est
originaalsus	est
лакс	myv
арслан	udm
tolvan	est
зебра	udm
шӹлеш	mrj
жив	myv
mitokondrioiden	fin
кансявтикше	myv
оцона	mrj
педявтомас	myv
рай	mrj
пелькскетне	myv
калявӓрӓш	mrj
январь	udm
кинематографиянь	myv
pensasmailla	fin
курган	mrj
asuintoverinsa	fin
vähendamises	est
ogalikest	est
yleislääkkeisiin	fin
крипицӓ	mrj
бӧрдӧдчанкыв	kpv
rannekorut	fin
sopulivuosina	fin
шӱ	mrj
йыдым	mrj
пычеш	mrj
mõisnikel	est
вис	udm
педучилищасо	myv
салым	mrj
инкубатoр	mrj
vereimejad	est
varapuhemies	fin
омынжы	mrj
тотлан	mrj
järjellisyyden	fin
bauksiitista	fin
избачӧн	kpv
сарансо	myv
порко	kpv
шайгузэ	udm
бурдо	udm
шыладсö	kpv
бульвар	mrj
оскись	udm
мероприятиеяс	kpv
автомагистраль	myv
картошка	udm
йöгра	kpv
haakimist	est
училищеас	kpv
бухта	mrj
национальносьт	kpv
kamassi	est
lippuautomaateilta	fin
deduktsiooniga	est
бот	myv
hausta	fin
фортепиано	mrj
myötäjäisensä	fin
marssimusiikista	fin
satukirjailijan	fin
путь	myv
сексӹ	mrj
puolivuotiaana	fin
мокшым	mrj
sarikõisik	est
кункышетэз	udm
полковник	kpv
кӧзяйство	kpv
пыремез	udm
räätsa	est
памятник	myv
увтырын	kpv
katarr	est
манеш-манешвлӓм	mrj
майталэн	udm
зобъяс	kpv
liustikele	est
иворчиос	udm
stažöörina	est
явовомась	myv
energiatasolla	fin
латунь	myv
модавтомо	myv
бура	kpv
sukeltamisessa	fin
boniteedi	est
lieveteksteissään	fin
шӱӓш	mrj
азбукаысь	kpv
аршашын	mrj
сiяс	kpv
ялштыш	mrj
существительноень	myv
пичепанго	myv
волокнатне	myv
тренерез	udm
фашистъясӧс	kpv
контраст	myv
toimes	est
эмтор	kpv
avaimenperiin	fin
vinnastus	est
чекистъяс	kpv
лӱлпер	mrj
stalinisti	fin
ryöstäjä	fin
лодка	udm
плетень	myv
терапевтэсь	myv
vapaasta	fin
витӓм	mrj
букварь	mrj
syntymäaikansa	fin
кельнень	myv
сирмӓшвлӓштӹ	mrj
ситцӹ	mrj
katapultidega	est
флотось	myv
заданизэ	udm
sessioonil	est
кылбурлэсь	udm
вомö	kpv
ботаника	mrj
карбасӧн	kpv
vahtkondade	est
катастрофа	udm
tarnade	est
soojendilt	est
кроликъёсты	udm
гердлэн	udm
суффиксэнзэ	myv
laoga	est
чукш	myv
väitluste	est
маклака	mrj
сьӧкыдлун	kpv
улiтi	kpv
mambost	est
kokissa	fin
koondatav	est
психика	mrj
содержаниянзо	myv
тигӹтвуй	mrj
эулофия	udm
даури	mrj
taganemiseks	est
балъёсы	udm
yhdennäköisyytensä	fin
ikonografiaan	fin
кирнявтомат	myv
диапозитивъёс	udm
сержантлы	udm
православиш	mrj
шунын	mrj
оргодиця	myv
džungel	est
яндöва	kpv
бам	udm
türklaste	est
taandrida	est
мошеш	mrj
уликс	myv
tallimääräyksen	fin
kišlakis	est
luonnonkansojen	fin
карьолго	myv
колхозыс	kpv
giljotiiniin	fin
migmatiitista	fin
сиён-юон	udm
уманзо	myv
озныть	myv
impressioon	est
оборона	kpv
сооружениеяслӧн	kpv
трилогиез	udm
työlupaa	fin
шоды	mrj
сянглеест	myv
кыръёсын	udm
вордонъя	udm
кудораськентень	myv
турвиненк	myv
килангов	myv
оптышын	mrj
нагрузка	mrj
экстерн	udm
maaslamaja	est
кларнет	udm
sosiaalisairaalaan	fin
орс	kpv
пӧртӧ	kpv
hapanmaitotuote	fin
teadasaamisel	est
лар	myv
pohmeluses	est
когершӹ	mrj
томуловкӧд	kpv
сценари	mrj
конфликт	kpv
пленэ	udm
канцёрой	myv
морӧс	kpv
зародышесь	myv
spoonist	est
sivuvaikutuksia	fin
весьттi	kpv
arvestusse	est
каваштывлӓштӹ	mrj
валгоманзо	myv
барсук	myv
traktorist	est
изделивлӓштӹ	mrj
охрана	kpv
leasing	fin
ялонэз	udm
пучывлӓн	mrj
mahutavuselt	est
karakumi	est
pakkausmerkintöihin	fin
кажовчинь	myv
хӹдӹртӹш	mrj
вӹтельӹвлӓ	mrj
масштаб	mrj
марявиця	myv
елабуга	myv
kaksikielisyydessä	fin
эсперанто	udm
hyveellisyyden	fin
уа	mrj
пельпомъясöдзыс	kpv
glaubrisoola	est
икмахатьвлӓн	mrj
сербъёс	udm
сибыд	kpv
selvitysmiehenä	fin
калий	myv
карусель	udm
dekoratsioonid	est
барабанщик	mrj
primitiivistä	fin
environmentalismille	fin
отражение	udm
pilgetega	est
piensijoittajia	fin
сырт	myv
литурги	mrj
лунвылö	kpv
шайвылзы	udm
фильмсӧ	kpv
пелыськайӧн	kpv
andmeteks	est
конструкцижӹ	mrj
ravintolalaivoissa	fin
taisteluvahvuuteen	fin
ламбаськень	myv
наследизэ	udm
kuraas	est
arterid	est
возённиосысьтызы	udm
писэйтурын	udm
суравка	myv
keilaus	fin
yksityissijoittajien	fin
управлени	mrj
нывбабаясӧс	kpv
абусьыс	kpv
asemapaikka	fin
бабун	mrj
шапренгӹ	mrj
форпост	myv
еврей	udm
kajastusena	est
турипув	kpv
сын	kpv
анекдотвлӓм	mrj
bulbulit	fin
talousjärjestystä	fin
kapinointi	fin
sublimoitumisen	fin
юкмöсö	kpv
pintapalo	fin
kulutusega	est
kujuteldamatus	est
kantelukirjelmälle	fin
сезема	myv
sopimusrikkomuksesta	fin
teollisuusrakennuksensa	fin
osmoosile	est
сывтень	myv
ныла-пиа	kpv
слон	mrj
paspartuud	est
арест	udm
brasiillasest	est
татартнэ	myv
романӧ	kpv
медицинаысь	kpv
чорыг	udm
sirkliga	est
паськыдінъяслысь	kpv
tuotantohinnan	fin
агаез	udm
primitivismiga	est
деготь	myv
идеологиштӹ	mrj
virginialaiselle	fin
пила	kpv
вараш	mrj
кудель	kpv
перелом	myv
анализт	myv
зынтурын	udm
piruetin	fin
ilmakompressorit	fin
профессоржы	mrj
чемень	myv
монумент	mrj
hermopunosta	fin
пуштмaш	mrj
vaatlejani	est
ammattimaisuus	fin
аштемась	myv
контактвлӓм	mrj
valuna	est
vihannestarha	fin
селое	udm
йӧрш	kpv
юргижӧд	kpv
источник	udm
йӓрмингӓ	mrj
княжествое	udm
plaksutamine	est
библиотекарь	mrj
муса	kpv
рудникым	mrj
normin	fin
janitšarist	est
arkiliikunta	fin
büste	est
helvet	fin
поезд	kpv
туаткал	mrj
чин	myv
vekki	fin
maastapoistamistaan	fin
кӹневлӓн	mrj
аллегори	mrj
tarakani	est
rassilta	fin
бандаяссӧ	kpv
miestenlehtiin	fin
миллионер	mrj
телеграмма	kpv
батист	udm
индеецвлӓн	mrj
кексвлӓ	mrj
уджмогъяс	kpv
ӱп	mrj
ваямось	myv
jullaga	est
влияния	myv
kinnituste	est
вардалӧн	kpv
пöраö	kpv
литераторкс	myv
авангард	udm
шнамо	myv
мускыт	udm
ruumina	est
катарлэн	udm
лобась	udm
ӹрвезӹм	mrj
зіясӧс	kpv
дядьӧ	kpv
кусок	kpv
suruliputuksessa	fin
куб	udm
йӹнгӹл	mrj
благовещенскоень	myv
kauneusihanteena	fin
paljutähenduslikkuse	est
гурезьысь	udm
пандокарязт	myv
vihvilöiden	fin
umpieritykseen	fin
чалльӧг	kpv
зоологи	mrj
сержантвлӓ	mrj
чальясыскӧд	kpv
кенешын	udm
без	udm
войпук	kpv
буйстэ	myv
студень	kpv
капусталӧн	kpv
вейкинеть	myv
инженер-механик	udm
бунтым	mrj
шокамзэ	udm
поляк	mrj
сырам	mrj
этажын	udm
старшина	kpv
мальӧ	kpv
ažiotaaži	est
internationalin	fin
киножы	mrj
leinamisega	est
фонетикань	myv
сӱк	mrj
сельмекерень	myv
эрьгинесэ	myv
машинӓвлӓ	mrj
йӧрсӧ	kpv
биграе	udm
комсомолецын	kpv
värinegatiivin	fin
ошаргекӹн	mrj
nohik	est
kurnasid	est
вельтямо	myv
жаг	udm
чеп	kpv
külastanud	est
igamisega	est
тулуп	kpv
занятивлӓм	mrj
вытьыс	kpv
ürikule	est
räjähdyspisteestä	fin
kahjutusest	est
туспуктэмъёс	udm
эмтодосъя	udm
ваёбыж	udm
зубр	udm
йӧктысьӧн	kpv
графжы	mrj
labakutest	est
syrjäisyyden	fin
пингвин	mrj
patendindusest	est
морфологиштӹм	mrj
koolkondadega	est
шулык	mrj
laiu	est
огазеян	udm
печказонь	myv
metsästysonni	fin
семантика	mrj
госплан	kpv
usaldatud	est
киш	mrj
торосост	myv
уж	kpv
tykeistä	fin
лекш	myv
öljyväreillä	fin
хлопочамонтень	myv
мальва	mrj
кылёнлэсь	udm
террор	kpv
сельди	kpv
вундысьö	kpv
пӧйшурасьёс	udm
ёжовчинь	myv
hatta	est
püsisid	est
пенсионер	mrj
ylioppilaslehden	fin
кырувсянь	kpv
esiletoomist	est
кывкöртöд	kpv
allegoorias	est
воторник	kpv
ӓрдӹ	mrj
обработка	myv
divisjoni	est
койкалы	udm
дикторӧн	kpv
adenosiinitrifosfaatin	fin
украинава	myv
институтыш	mrj
функцияст	myv
пинь	kpv
идол	kpv
полковник	mrj
sinoloog	est
писаркӧд	kpv
тöрöканöс	kpv
заводъёсы	udm
emikukintoja	fin
соктавлӓм	mrj
юрвлӓ	mrj
ruteenien	fin
ellujäämises	est
нергӹ	mrj
комедия	kpv
гармонь	udm
истуканвлӓлӓн	mrj
касажым	mrj
puhdistusaineita	fin
ӟиллё	udm
konsultatsiooni	est
vohasid	est
eksprompt	est
konsonanttivartalon	fin
трявкс	myv
kabina	est
rühmitist	est
initiaatiomenoissa	fin
todennäköisyysteoriaan	fin
акциез	udm
аспирантура	kpv
мог	kpv
ленинец	udm
тештинеть	myv
пoл	udm
residentiksi	fin
треска	kpv
колхозницаяс	kpv
лапушкасонзо	myv
кокос	kpv
evakuatsiooni	est
обязанностьвлӓм	mrj
пуштын	mrj
isoleerimiseks	est
беднота	myv
родньыквлӓ	mrj
hautakirjoituksensa	fin
lysiiniä	fin
laiahaardelisuses	est
roomalaiskatolinen	fin
edustuslaitoksensa	fin
лӥялъёс	udm
статистика	mrj
donitseja	fin
верькст	myv
косуля	kpv
представительство	kpv
elitaarsuses	est
котыръяс	kpv
kartanonomistaja	fin
пӓшӓзы	mrj
висъяменыз	udm
чурамоначконь	myv
arvokalojen	fin
кӧчильӧй	kpv
vaalipäivänsä	fin
словакъёс	udm
цигӓн	mrj
formulatsiooni	est
кыз	udm
moderaatorina	est
кукшуннэнь	myv
шӹштӹ	mrj
ӱэлӓ	mrj
autoritarismini	est
vabastatus	est
sotaleikkejä	fin
течи	myv
ингур	udm
tindis	est
kostmiseks	est
азарт	mrj
невестань	myv
интонациянь	myv
уртшак	kpv
абхаз	udm
otteluistaan	fin
kultahampaat	fin
арававлӓштӹ	mrj
вордӥсез	udm
шытырланымаш	mrj
mandingoa	fin
okapeilla	fin
галацеця	myv
лехинеть	myv
hüsteeriani	est
пластинка	myv
safiirien	fin
hospidaliks	est
реабилитаци	mrj
ылем	mrj
monitooringuga	est
участокын	kpv
социализмань	myv
lokaalis	est
сизьёс	udm
нимы	udm
sajast	est
талант	myv
mustangi	est
sahkerdamisest	est
lektoriteks	est
шуге-леке	udm
шӹнгӹртӹш	mrj
deklinatsiooni	est
реставксонть	myv
резина	kpv
üllatusena	est
läpimurtoteostaan	fin
кылдытэтэ	udm
пекшень	myv
väli-isännistä	fin
паличӧн	kpv
знак	kpv
гарнизонэнызы	udm
aitamises	est
межава	myv
tallinlanna	est
гражданинэнь	myv
округ	kpv
rippe	est
комета	mrj
jungilaiseen	fin
пуля-порок	kpv
kuulo	est
бланк	udm
йылпумъя	udm
palkade	est
killustatus	est
meandrid	est
яган	udm
siittimen	fin
конфетӹм	mrj
шкерьгень	myv
кренчесь	myv
армиын	udm
лагерӧн	kpv
драмаяс	kpv
шудонлы	udm
бушковъяс	kpv
pihtide	est
пушт	myv
tervitustele	est
процентэсь	myv
polvivammaan	fin
tõlgenduseks	est
klavessiinidel	est
пӹчкӹквлӓм	mrj
salaattikastikkeet	fin
valmiustilan	fin
авторӧс	kpv
koivukasveihin	fin
kilpailukykynsä	fin
poni	est
retsidiiv	est
цамавач	mrj
кодавкс	myv
вунэтэм	udm
никто	myv
арняе	udm
plastilisuse	est
suverääni	est
управление	udm
чехословакишты	mrj
кодор	myv
tahtluse	est
кылбуретэ	udm
visavii	est
libeerlased	est
ашнымашым	mrj
республикын	mrj
евро	myv
formulointi	fin
sähkövoimatekniikassa	fin
britannialaisia	fin
вӹдвӓрӓ	mrj
entiteettien	fin
пановлы	kpv
аярлӹпӹн	mrj
röntgenlähde	fin
религия	udm
nyyssit	fin
архипелагын	udm
ӵыпетам	udm
kütis	est
лилиянь	myv
веник	udm
партнёрез	udm
родонь	myv
метьказ	myv
буйдуктикше	myv
lihaksisto	fin
частица	mrj
сантнэва	myv
kaseiinista	fin
spontaanisuuden	fin
шормуӵъёс	udm
гырйöс	kpv
гимназиялӧн	kpv
реаливлӓм	mrj
йӓмдӹлӹмӓш	mrj
роштувань	myv
консультант	udm
тупӹрдӹн	mrj
потиця	myv
шодышуды	mrj
карсун	myv
кöзаясöс	kpv
тымдымашын	mrj
ведьпрамо	myv
kessel	est
донзо	myv
филолог	mrj
затон	kpv
метафора	mrj
vuosihuollon	fin
ворттӥсьёсыз	udm
снайпер	kpv
амӓл	mrj
кыдаз	udm
epäkunnioituksesta	fin
церкӹвлӓштӹ	mrj
возьдаськон	udm
лаханс	myv
тэг	kpv
abiogeneesi	est
алинень	myv
храмось	myv
паргост	myv
преступлениэш	mrj
парямодо	myv
roimade	est
nakatus	est
пертасъяс	kpv
oksendamisega	est
ламолгавтомаст	myv
maailmanmenestykseen	fin
сёрнисикасъясын	kpv
toetamises	est
лёдзьяс	kpv
työllisyyskoulutuksessa	fin
reformijuutalaisuuden	fin
йӧлогуби	udm
корпорация	udm
чивалгомаёнксонь	myv
flokse	est
лабичьяс	kpv
цокеш	mrj
касовкска	myv
ёзэсэз	udm
кузнеча	kpv
пешксесэ	myv
велямодо	myv
rünnatuna	est
ёрыш	udm
heikkonäköisyyden	fin
kieliteknologian	fin
арланэз	udm
kunda	est
прöдуктаяс	kpv
мужанеш	mrj
шудэменыз	udm
lihanjalostus	fin
ошпач	mrj
kapinaliikkeiden	fin
степеньӹм	mrj
рядовойвлӓ	mrj
пур	kpv
ярмаркаос	udm
pääsenuks	est
kipuna	fin
туян	myv
пижоргым	mrj
корёнонок	myv
юӧръяс	kpv
нур	kpv
setelirahoituksen	fin
pariluistelua	fin
мельсэнек	myv
спас	kpv
коэм	mrj
кукушкапря	myv
офицеръёслэн	udm
князьёс	udm
христианства	myv
vuorovaikutteisuus	fin
kooslustest	est
шадралы	kpv
сёрмалема	myv
likviidsus	est
ilmaletoomist	est
педагогикая	udm
ой	kpv
пустыня	kpv
панжомаст	myv
белок	myv
ketteryyttä	fin
androgyniasta	fin
норма	mrj
хорлы	kpv
питнейчинзэ	myv
мамыкым	mrj
тар	myv
egotism	est
спортсмен	myv
saatmiseni	est
loppupäätelmään	fin
citylle	fin
antimoni	est
apooriasse	est
омра	kpv
grimeerijana	est
копият	myv
телескоп	kpv
таты	mrj
сиргек	mrj
паломастост	myv
nokka-akseleissa	fin
оланпасыс	kpv
шӓртньӹ	mrj
гонораржы	mrj
центрын	udm
режимвлäн	mrj
пеледмӓш	mrj
утро	udm
классикъёсты	udm
паксятикше	myv
вӹргечӹ	mrj
palladiumilla	fin
sor	kpv
lauluillaan	fin
вишпилявонь	myv
оркестрын	udm
компаниясь	myv
rohustu	est
кылбурчиен	udm
цимбирень	myv
куазь	udm
судо	myv
энциклопедилэн	udm
артельын	mrj
массивыслöн	kpv
ноябр	kpv
манашкеш	mrj
läbikukkumiseni	est
сюлмотне	myv
его	kpv
ӝуам	udm
ничего	myv
пряпесэнзэ	myv
imusuonistoon	fin
keittiöapulaisena	fin
арифметика	kpv
шеньӹкӹм	mrj
markkinoilletulo	fin
цифратне	myv
грек	udm
метафора	kpv
евреень	myv
rahe	est
direktoriga	est
dogmaatikat	est
kalansaaliin	fin
управакӧд	kpv
järeleaimamist	est
торот	myv
гаранти	mrj
очеркыс	kpv
кулозесь	myv
анайлэн	udm
valtakunnansalia	fin
чувтумарень	myv
быдмöгулов	kpv
студияын	kpv
лöп-ёг	kpv
интервью	kpv
шӧкыч	udm
полина	myv
купанча	udm
sopistustest	est
банданть	myv
председатель	kpv
etääntymisellä	fin
gamla	kpv
пичекивге	myv
seadusandlusele	est
барон	myv
карязовтнень	myv
kaevist	est
свинец	mrj
dooria	est
лӥялгубиысь	udm
цёков	myv
кавтаськеть	myv
путёвка	mrj
печень	myv
тополь	kpv
selginemine	est
keskinormaalit	fin
anarkistisuus	fin
баобаб	udm
eumeniidides	est
киргизэнь	myv
haldaja	est
бугыръяськонъёслы	udm
активист	kpv
абзац	mrj
porsa	est
изделият	myv
jokamiehenoikeuksiin	fin
loksodrominsa	fin
закладö	kpv
кудыжы	mrj
ikkunankarmiin	fin
museaale	est
нюраинын	kpv
нурдсот	myv
мутассӧ	kpv
горъяс	kpv
kivihiilikaudella	fin
riivaajien	fin
пуксён	udm
спектакльвлӓжӹм	mrj
умарнестэнзэ	myv
vilja	est
шоссе	kpv
ологат	myv
kohteen	fin
missas	est
pedantidega	est
гöгöртассö	kpv
цинни	mrj
гитараен	udm
усьто	udm
цанг	mrj
существатнень	myv
кыдатон	udm
кенгуру	udm
монография	kpv
палшымаш	mrj
центнер	udm
специалист	myv
глагол	kpv
ӧдйӧ	kpv
harmaaoravan	fin
yhdysosa	fin
кикы	udm
бичам	udm
кундсематнеде	myv
трагедиш	mrj
аистэнь	myv
yhteentoimivuutta	fin
oravatel	est
ratapyöräilyssä	fin
ӓкрӓмӹштӹ	mrj
куашкан	udm
tundmatuid	est
собственностья	udm
сётонъя	udm
контроль	mrj
arhitektuuridel	est
кенешоназ	udm
экскурсия	kpv
märketa	est
лача	kpv
business	fin
сöстöмлунсö	kpv
professio	fin
бра	udm
шуö	kpv
вöльгымын	kpv
частьсэ	myv
niemimaaksi	fin
акула	mrj
valonarkuutta	fin
roki	est
насекомойде	myv
depressiotiloihin	fin
виштыосыз	udm
спазма	myv
правилань	myv
brysseliin	fin
берытскон	udm
polod	est
itiöemä	fin
свидетельствоез	udm
шелк	myv
verisukulaisuutta	fin
тиф	kpv
толйись	udm
выйим	kpv
ошмес	udm
бумага	udm
рапсоди	mrj
sodanlietsojana	fin
kastreerimine	est
суддянас	kpv
дойяс	kpv
рытӧдз	kpv
кыва	mrj
jan	kpv
гынэ	udm
национальность	kpv
концертэнь	myv
затон	mrj
porte	est
alkukeväästä	fin
sfääris	est
археолог	mrj
лыдъян-чотанын	udm
kuuluvusest	est
рӧдъясӧн	kpv
гöстинеч	kpv
урод	udm
майор	mrj
этш	kpv
olantsapiini	fin
государствань	myv
этимология	udm
yleistilanne	fin
шакте	mrj
бакель	udm
овтоумарь	myv
pilviin	fin
элeгиштӹ	mrj
армияас	kpv
сӓрӓнӹштӹ	mrj
vastetel	est
кыпыдлун	kpv
palkaksi	fin
юдэс	udm
азбука	mrj
ülekandumine	est
röövlitega	est
мӱландӹштӹ	mrj
суднояссӧ	kpv
диверсантъясӧс	kpv
invarianssi	fin
room	est
качадома	myv
kalsiumkarbonaatti	fin
harmooniatele	est
контрреволюция	kpv
тестьыслӧн	kpv
romantiikaksi	fin
sinoloogia	est
ӹлӹшӹ	mrj
rakmetesse	est
таптымаш	mrj
маятник	myv
kündja	est
фельетонвлӓжӹм	mrj
условиеяс	kpv
nahkaleileistä	fin
jaotused	est
dosimetria	fin
tõotusele	est
латынь	myv
tehtäviinsä	fin
kahdentumisen	fin
toitest	est
taiplikkuse	est
бюст	myv
вим	mrj
тшыглы	kpv
адвокат	mrj
reservuaar	est
рост	myv
ape	fin
арӧс	kpv
империяын	kpv
зонт	myv
кепысь	kpv
vuosikasvusta	fin
etteandmist	est
зарезьёс	udm
трактористлысь	kpv
медицина	mrj
golemista	fin
ушымаш	mrj
kordofoneihin	fin
sivumyymälöitä	fin
метафораос	udm
кузолыс	kpv
библия	udm
selgusetus	est
пельса	kpv
puuttumisten	fin
моронзо	myv
kidnappaajiaan	fin
сылалтон	udm
pühendumusega	est
golfammattilaisten	fin
чачаяс	kpv
чушканзi	kpv
vetruvus	est
квартетӹштӹ	mrj
ӱштӹмыж	mrj
kulttuuriradikalismin	fin
karsi	est
император	mrj
лодъясысь	kpv
klambrid	est
хоккейысь	kpv
riitajutuilla	fin
ыражвлӓэш	mrj
тодык	mrj
fagotist	est
бӧлбанъяс	kpv
пединститутын	kpv
ummistuse	est
pälk	est
инструктор	udm
ракета	mrj
топонимлэсь	udm
реализмань	myv
mamelukid	est
мор	mrj
этимологи	mrj
tapit	fin
эвакуациштӹ	mrj
возён	udm
тӧллэсь	udm
hydrideiksi	fin
opintovaatimusten	fin
марганецэнь	myv
цӹвӹштӹм	mrj
идеология	kpv
palmuöljyä	fin
ад	myv
калямо	myv
нолдавксонь	myv
ӓнисӹн	mrj
ärahoidmise	est
лейтнесэ	myv
вишнёпка	mrj
бӧжас	kpv
олмавлӓм	mrj
hetmanite	est
леопардъяс	kpv
кывкудъясас	kpv
политрук	myv
painekattila	fin
puutavarakauppa	fin
интыяськон	udm
библиотекар	kpv
верьсанонзо	myv
опералэн	udm
lautaverhous	fin
тӓреш	mrj
кафе	kpv
leikkimielistä	fin
званим	mrj
артистлы	udm
põssa	est
kammeljas	est
krupjeele	est
aallossa	fin
прогресс	udm
кулэяськонъёссэ	udm
moottoriöljyä	fin
беседа	myv
йиыс	kpv
jaapanlannadest	est
сообщеним	mrj
васкан	mrj
пуштамось	myv
кордононзо	myv
isoenonsa	fin
детдомын	kpv
фольклористика	kpv
курган	udm
дари	kpv
тире	mrj
отсӧгӧн	kpv
нужголвлӓ	mrj
орешкат	myv
мильӹн	mrj
mäntymetsät	fin
diilerite	est
молодец	mrj
гырпум	udm
мордва	myv
иллюстратор	myv
идея	myv
дубинкань	myv
luonnonmuistomerkki	fin
характеръясыс	kpv
праваяс	kpv
техникалы	udm
kryoliitista	fin
кардазонтень	myv
heeroldit	est
режимлы	udm
aparaatidega	est
сульдэр	udm
бархат	mrj
кантораысь	kpv
leitnandi	est
люкетъёслы	udm
мангуст	udm
янгеж	mrj
синмыз	udm
sammuke	est
этнохореологъёслэн	udm
ген	kpv
уша	mrj
узырмытон	udm
кулонлэсь	udm
näinus	est
resümeest	est
фотокорреспондент	kpv
лакамо	myv
паракод	kpv
пӹзӹрньӹк	mrj
палата	udm
vihertikkoina	fin
лабораториянь	myv
венеци	mrj
моллюск	mrj
puna-armeijasta	fin
азот	kpv
polütehnikumi	est
губка	mrj
шыдэнызы	udm
mulin	est
судэ	udm
тергӹмӓшвлӓжӹм	mrj
valitsuse	est
ватсэтэз	udm
duk	kpv
müüdavusele	est
пирӹванды	mrj
нулакс	myv
национализм	kpv
kom	kpv
луонлыксы	udm
sõrmuse	est
кӧнӧвал	kpv
лый	mrj
пувозонть	myv
hivenaine	fin
nieriää	fin
пызандӧра	kpv
saattamista	fin
eläintieteessä	fin
бригадась	myv
левкске	myv
raivio	fin
арбериосты	udm
правоя	udm
таксономи	mrj
механизаторӧн	kpv
зук	kpv
чунькытшъяс	kpv
аттестацизыя	udm
latojaksi	fin
функционированижӹ	mrj
кунлык	udm
пиявка	kpv
silurini	est
труппа	mrj
hüpik	est
simulatsiooni	est
баш	udm
frankfurdi	est
reportaaseja	fin
alusetust	est
кöлöкöльня	kpv
армие	udm
йӧртӧд	kpv
eksentrikko	fin
заданиеяс	kpv
бордйыслӧн	kpv
рушӓрня	mrj
свадьбанзо	myv
суртым	mrj
savumerkeillä	fin
яйöн	kpv
каш	mrj
пединститутэ	udm
kurssinoteerausta	fin
войскоосын	udm
специальностьым	mrj
ядым	mrj
индӧдъяс	kpv
енэжва	kpv
модель	myv
паксякарго	myv
эксэйёс	udm
сенаторӧн	kpv
кезьыт	udm
колбаса	udm
hakitust	est
исключени	mrj
bon	kpv
uralist	est
lämmöneristys	fin
bot	kpv
комедиянть	myv
джуджда	kpv
нежедемась	myv
пур	udm
фрескасо	myv
tehtuga	est
хорсо	myv
маркаосты	udm
rynnäkköpanssarivaunua	fin
героизмлэн	udm
kaasuvakio	fin
шижмäшӹм	mrj
квотань	myv
luonnonilmiöistä	fin
карачай	udm
seismoloogid	est
juoppohulluuteen	fin
бертэм	udm
valvsust	est
локшосо	myv
бышкись	udm
попем	mrj
koola	est
holografiaa	fin
сартассӧ	kpv
юркарыс	kpv
тулыс	udm
idiootia	est
синучкон	udm
преданилӓн	mrj
вуриськисьлэн	udm
ирони	mrj
шунгаг	kpv
pelikan	est
öljynjalostamoksi	fin
декан	myv
leegioniks	est
давленим	mrj
сборникъёсазы	udm
лапкашты	mrj
глухой	myv
ӧнерчиосын	udm
fenomenoloogiaga	est
каштан	mrj
asuntopula	fin
sig	kpv
наследство	kpv
бухгалтерия	kpv
генерал-лейтенант	udm
куротнесэ	myv
расследованивлä	mrj
микрофильмъёс	udm
пучер	kpv
экономист	udm
инзейведекс	myv
чика	myv
ümbermaailmareisiks	est
neandertali	est
иа	mrj
moottoriurheilijoille	fin
aerosoleja	fin
tuotantotekniikka	fin
мансинь	myv
новланторъяс	kpv
радио	udm
öгуречьяслöн	kpv
экономистӧн	kpv
ударник	udm
kiistämisestä	fin
плакатонь	myv
ulvilalaisessa	fin
джаз	udm
varpaisiin	fin
дирижёр	kpv
комод	mrj
характерэст	myv
шлём	myv
борды	udm
чельньӹквлӓ	mrj
юрлӧс	kpv
сермадовксос	myv
kirmas	est
дворянинлӓн	mrj
гырон-кизён	udm
ушемӹштӹ	mrj
урьванть	myv
каркытшъяс	kpv
анжалтышым	mrj
вимгӹ	mrj
венгер	udm
puhkekodusse	est
школадо	myv
чекамо	myv
нуон	udm
люказы	udm
toteemin	fin
минутэ	udm
jagamatusega	est
бес	kpv
дуриськисьлэн	udm
esi-isälleen	fin
инфлуэнцижӹ	mrj
поэтэнь	myv
лингвист	kpv
шонертон	udm
эчкеть	myv
император	udm
vahakabinetin	fin
лонган	mrj
чесьт	kpv
вуйгӹшӹл	mrj
степеньёс	udm
экскурсиос	udm
näkemänsä	fin
физик	myv
hooplemine	est
лапӧдӧн	kpv
платина	mrj
кайяссӧ	kpv
haastemiehet	fin
автопавильон	kpv
стильсэ	myv
jälkitaudit	fin
цитрус	mrj
текстын	mrj
крезьгурчи	udm
ракета	udm
парадэ	udm
määrast	est
капитализм	kpv
планетазы	udm
suurlepakkoja	fin
республикат	myv
лев	kpv
йӹгӹр	mrj
юрыд	kpv
тарвашвлӓ	mrj
etupuolen	fin
salsasta	fin
sünergia	est
кухнят	myv
гвардия	udm
отчизна	kpv
поцерьсэ	myv
viiltäjästä	fin
сӓрӓлтӹшвлӓ	mrj
julkistaminen	fin
камбразонь	myv
церемоништӹ	mrj
милициясо	myv
нод	udm
лидерэсь	myv
ой	mrj
väestönsä	fin
сероень	myv
мерян	myv
otsimisel	est
майор	udm
номере	udm
kapslite	est
vihtlemist	est
критериятнева	myv
transitiiviverbejä	fin
шашкасӧ	kpv
jalast	est
баклант	myv
kroonis	est
ламбамопель	myv
автомобиль	mrj
нефтяникень	myv
элементъёсъя	udm
uisutamisse	est
семья	myv
юж	udm
jää	fin
onnenpäivä	fin
orpopoika	fin
следопыт	udm
палыкандал	myv
кӱвлӓ	mrj
утчамзы	udm
штабонь	myv
философ	mrj
вежӧдӧ	kpv
пумазы	udm
велӧдчысьӧн	kpv
illustraatorid	est
кемекстамодонзо	myv
кӧргӹш	mrj
йӓргӹльӹ	mrj
kalsiumia	fin
советсэ	myv
мынонэз	udm
agoraa	est
šamanismist	est
potas	est
принеть	myv
ülestõusnutel	est
собрание	udm
гожазы	udm
механизмъёсын	udm
шавыр	mrj
атом	mrj
sur	kpv
кавалерист	udm
ӹзӓк-шоляк	mrj
ярыктымаш	mrj
жасмин	udm
rüvetus	est
ояксчи	myv
мордва	udm
шаеръёсты	udm
frantsiisi	est
ватерӹм	mrj
бахча	mrj
сюра	kpv
гундырлöн	kpv
kaalutlustel	est
irtolasteja	fin
mulliga	est
kaunitar	est
блокъясӧн	kpv
лякма	udm
геолог	myv
сурсеманть	myv
религия	kpv
ашкылвлӓ	mrj
каремеш	mrj
космосыш	mrj
kierrätystä	fin
ordinaariuseks	est
tilkkutäkki	fin
ёмавтомань	myv
волостьыш	mrj
очеркист	myv
царь	kpv
kivitaulua	fin
öтувтö	kpv
kärryjen	fin
свалшкань	myv
декабристъёслэн	udm
ишкӹм	mrj
субтропикень	myv
кораськем	udm
häpykarvat	fin
максарь	myv
клеткат	myv
отделенияз	udm
mängimist	est
арифметика	mrj
colosseumilla	fin
изьверъёслэн	udm
чумовтомо	myv
канава	kpv
кöйдыссö	kpv
сутэр	udm
набой	myv
mandrilt	est
витнема	myv
баттерфляй	myv
tüdrukuna	est
кумбрят	myv
сборникъясас	kpv
архангелӹн	mrj
ympäristötieteissä	fin
касытаркав	myv
purismi	est
нолжым	mrj
отчет	mrj
чачтоманень	myv
rektorist	est
stressitilanne	fin
сияждыця	myv
тыштывлӓм	mrj
конкуренци	mrj
командаясӧ	kpv
парторгез	udm
пачкаын	kpv
дурон	udm
срок	kpv
феодализм	kpv
челябань	myv
кам	udm
полиграфи	udm
taster	est
кӹрӹлтмäшвлä	mrj
ялава	mrj
мушкотикше	myv
новатор	mrj
яблöк	kpv
пиосъёслы	udm
тыметъёсыз	udm
tekstitoimeti	est
jaotumust	est
лемта	udm
конкурентӧн	kpv
кудолемтне	myv
преподавательӧн	kpv
куремезъя	udm
гудок	udm
бюрократъясӧс	kpv
vaunun	fin
идеме	myv
leeted	est
luonnontapahtumien	fin
lapasotkan	fin
юкöныслы	kpv
pisted	est
кодекс	myv
скотинань	myv
plaste	est
rõhutuse	est
перспектива	kpv
мануфактураос	udm
скаллы	udm
velkojat	fin
norske	est
redaktsiooni	est
kassiitteja	fin
ettevalmistamisega	est
кузнецтне	myv
punajäkälää	fin
графика	udm
varundusi	est
циклын	mrj
неологизм	mrj
ammoniaagiga	est
pretensiooni	est
олимпиадае	udm
цотнай	mrj
шкoлаын	udm
haiti	est
оро	mrj
röntgenoloog	est
национальностьвлӓ	mrj
plaastrite	est
nuru	est
ohtudest	est
тэчасног	kpv
ведомосьтын	kpv
миндэр	udm
гуранторйӧ	kpv
normaalilyseossa	fin
магнит	udm
ис	kpv
eineks	est
käyttökunnossa	fin
чувар	myv
эротика	udm
явшема	myv
дзоньвидзалун	kpv
нюлэсъёс	udm
цӓци	mrj
бурпал	udm
gnoseoloogiat	est
математикаысь	kpv
куль	kpv
бызись	udm
яжамонь	myv
aeglus	est
sunnien	fin
логер	mrj
киветь	myv
nereiidide	est
слог	mrj
династи	mrj
сус	kpv
орфографилэн	udm
спичка	udm
valkein	fin
ristikolla	fin
човалят	myv
korratust	est
вадыжвлӓ	mrj
портъяссянь	kpv
старостаӧн	kpv
arkaaniks	est
ловмасо	myv
свет	mrj
атлетикая	udm
hool	est
кит	myv
тевесь	myv
картина	udm
kiki	est
jalohaukkalintuja	fin
teleoloogiale	est
пыртон	udm
йӓрӹмӹм	mrj
ёзэн	udm
кит	mrj
yliherkkyys	fin
organiseerijate	est
эфираз	udm
пöльзаыс	kpv
фарси	myv
корасьёслэн	udm
вӹргеньӹ	mrj
слӧбӧдакӧд	kpv
пöйшурлэсь	udm
дагестан	mrj
инескеть	myv
лапаэш	mrj
санитаркась	myv
маршал	udm
un	kpv
esperantolle	fin
шона	kpv
губорьксэкс	myv
jättihauen	fin
пассажиръёс	udm
элементыс	kpv
pessaari	fin
скушнас	myv
вурыс	kpv
панарт	myv
штаб	udm
повестез	udm
кылпум	udm
кузь	kpv
palvelutaseen	fin
topsel	est
balustraadiga	est
politikoinnin	fin
harrastelija	fin
вичьяслы	kpv
агитацияя	udm
sujuvus	est
huiskan	fin
talousteorian	fin
naisseikkailuistaan	fin
зӧр	kpv
painatteissa	fin
запань	kpv
вӧскресенньӧ	kpv
тодса	kpv
poolthääled	est
идеалист	mrj
фeoдaлизм	mrj
педагогика	mrj
цирейлопань	myv
hobiks	est
faksi	est
vapausrangaistus	fin
цацымашым	mrj
немечьяслӧн	kpv
усточи	udm
ennistamisest	est
мокша	mrj
omavaraistalouteen	fin
староверъёслэн	udm
platsentasid	est
märjukest	est
süüdistajana	est
пехота	mrj
январесь	myv
beeta	fin
барометржӹ	mrj
perinnäistapoihin	fin
билет	kpv
kevytmargariineissa	fin
улосвыллэн	udm
пессимизм	mrj
цехвлӓм	mrj
налим	udm
ал	udm
вöръяслы	kpv
veidike	est
бортмеханикӧн	kpv
seismajäämiseni	est
tiesulut	fin
орозбие	myv
нер	mrj
визьноданъя	udm
просветитель	mrj
художникез	udm
эсеръяс	kpv
ühika	est
трактористт	myv
abhaasin	fin
нылмуртъёс	udm
vaolise	est
узыез	udm
пегӟем	udm
полушариянзо	myv
mikrobilääkkeillä	fin
matkailumaata	fin
озименек	myv
muurahaiskäpyä	fin
изнявксось	myv
kansipaikoilla	fin
агитацие	udm
монументсӧ	kpv
ревень	myv
maastostaan	fin
керямо	myv
вариантъёссы	udm
сикан	udm
ӹштет	mrj
виангдӹмӓш	mrj
вата	kpv
дасямын	udm
архитектор	udm
svastikat	est
пумитъяськон	udm
стынсӧ	kpv
väikesepalgalistele	est
шляпӓм	mrj
шӧвригӓ	mrj
kommide	est
ваулаӧн	kpv
герӟамын	udm
стильын	udm
коласлöн	kpv
эффект	mrj
gümnasistil	est
ахальы	mrj
башкир	myv
карантинэн	udm
sametisse	est
палась	udm
комбинатлэн	udm
muotivillitykseen	fin
томбавомас	myv
керöсаин	kpv
слёт	myv
макарон	mrj
imur	est
астрономи	mrj
пилямо	myv
репрессиосын	udm
шождань	myv
новелла	mrj
harjoitusajossa	fin
сузын	mrj
сиёнэз	udm
лыддьöмторъяссö	kpv
öтувъялун	kpv
плетьӧн	kpv
kanali	est
lõpetamisel	est
окопвлӓм	mrj
сем	myv
лажамо	myv
ongessa	fin
заданиятнень	myv
faunas	est
оштолэзе	udm
понав	myv
konfetti	est
pealsed	est
транспортъя	udm
целанек	myv
тенстть	myv
sieluaan	fin
ревизияя	udm
корья	kpv
чутік	kpv
революци	mrj
suvantoon	fin
капитализмӹн	mrj
августын	kpv
pruunideks	est
онг	mrj
патылеш	mrj
разведкань	myv
ruokareseptin	fin
механик	mrj
кымдаэмдӹмäш	mrj
чопотемас	myv
карштышым	mrj
omantunnonvapauden	fin
металлургияя	udm
зятьыс	kpv
кымӧръяс	kpv
вӧзьясӧс	kpv
ganglioni	est
крокодилвлӓн	mrj
rakennusviennin	fin
пыдвыл	udm
vuodattaminen	fin
hyveisiin	fin
печаль	myv
помещикъёс	udm
черкогуртэз	udm
пилипызь	kpv
кунсьӧр	udm
прӧсек	kpv
virastoihin	fin
sisävesiväylää	fin
маткат	myv
metseenidele	est
tuntust	est
коллективизация	udm
станцие	udm
пел	mrj
оригинал	myv
кӹшедӹк	mrj
финнлӓн	mrj
тюрагай	udm
препаратвлӓштӹ	mrj
sosiaalipsykologit	fin
дисциплина	kpv
референтэз	udm
свӧякъяс	kpv
коэм	mrj
пеймыт	udm
õitsilised	est
rask	est
контораын	kpv
konesaleissa	fin
inimlikkust	est
pudasjärveläisiä	fin
šamanismille	fin
karaiimi	est
свӓщенникӹн	mrj
ӹнянӹмäш	mrj
sirgjoonelisuse	est
бубылиос	udm
сюсь	kpv
radioviestintään	fin
ванна	udm
mullistuksia	fin
lisandumiseks	est
вазымаш	mrj
норовавань	myv
эпитафият	myv
хормейстерез	udm
пивась	myv
проректорез	udm
ядыштмаш	mrj
конституцияяс	kpv
unelmiensa	fin
сувенир	mrj
германечьяс	kpv
электрикӧн	kpv
дзор	kpv
ес	kpv
тарадтомот	myv
sadekausina	fin
дурлоозяз	myv
пуны	udm
родник	mrj
тымeньмӓшӹм	mrj
ботанъясӧн	kpv
loppulauseeseen	fin
matkaaja	fin
perunalaatikot	fin
raasukesi	est
договор	udm
инсценировка	myv
parturiin	fin
веглясьысьяс	kpv
мувыръёс	udm
сельсоветъёслэн	udm
диалогонь	myv
pinnaseks	est
эмансипациянь	myv
гербер	udm
недлячисэ	myv
ватэмын	udm
ӓпшӓт	mrj
sudenmarja	fin
капстасто	myv
кӹтӧвлӓм	mrj
аддзысям	kpv
острокышты	mrj
ӟичы	udm
комментаривлӓм	mrj
воеводстват	myv
саами	kpv
шоглунлöн	kpv
харт	mrj
челяднень	myv
мельнича	kpv
лесной	myv
хор	mrj
костромань	myv
позань	myv
куюк	udm
нöк	kpv
тирӹшкӹ	mrj
цепжӹ	mrj
гастрольтнень	myv
товыра	mrj
mikkelistä	fin
уськеть	myv
артнеманть	myv
skepsist	est
praadi	est
ёртыцясь	myv
ulko-ovea	fin
paljunduseks	est
пештеть	myv
kehuskeluun	fin
кипомысь	kpv
mitalisaaliin	fin
пирӧг	kpv
lyyli	fin
süttimisest	est
костюмъя	udm
sydänpotilas	fin
лунас	kpv
донаторъяс	kpv
политикень	myv
грамотаезъя	udm
сорастӧ	kpv
мониторингъя	udm
каргыжвлӓ	mrj
ньӧр	kpv
алдыр	mrj
aktiivilomat	fin
верöс	kpv
картош	udm
repressioonidega	est
субсидивлä	mrj
кырымӧн	kpv
empirismi	est
halastuses	est
impressionismille	fin
kuutamoa	fin
фронтонть	myv
enamuselt	est
sekreedi	est
кузык	mrj
yksityismailla	fin
кемема	myv
статья	kpv
neulanpistopolitiikan	fin
valitsemisele	est
pilottitutkimus	fin
радиостанцияӧн	kpv
омырскемъёссы	udm
ränile	est
свадьба	kpv
цӓрӓгеквлӓн	mrj
elamuste	est
точкаосысь	udm
sott	est
тубрасын	kpv
kausityöntekijät	fin
экспозици	mrj
образование	kpv
музейӹштӹ	mrj
дядьӧ	kpv
тулысь	kpv
слепöкур	kpv
дарали	udm
lõhelistest	est
контракт	myv
родство	kpv
оро	mrj
конституцилы	udm
цюлансто	myv
модельвлӓлӓн	mrj
туйкост	kpv
istandikega	est
ономастика	myv
катыдсалы	kpv
шожым	mrj
радлык	udm
мусирлöн	kpv
страдна	kpv
konsortsiume	est
letid	est
lükandi	est
кывбур	kpv
рудат	myv
ilmestyksensä	fin
polkupyöräliikennettä	fin
demobiliseeritud	est
маршал	kpv
воштӥськемез	udm
интернат	udm
плакатвлӓм	mrj
sillal	est
loistoaikoina	fin
сухая	myv
вакцина	myv
дифтонгт	myv
idolatria	fin
вальмазонзо	myv
облисполкомлэн	udm
нылысь	kpv
палэпен	udm
пӧлы	udm
krõbeduse	est
акациясь	myv
корзинка	udm
ямт	myv
катанчи	udm
тӹлзӹштӹ	mrj
лажныця	myv
картаув	kpv
raskejõustiklastest	est
певтеметь	myv
культурa	mrj
relsside	est
экземпляр	kpv
tiaisten	fin
кеметь	myv
frankofiili	est
ужонть	myv
чамачачот	myv
дворечлы	kpv
бамъёсаз	udm
duuria	fin
luuta	fin
академик	mrj
mänedžerile	est
энергетикань	myv
версим	mrj
hongkongi	est
latva	est
декабр	kpv
kakofoonia	est
katsomot	fin
налогым	mrj
тон	kpv
autokantaan	fin
математикым	mrj
кайтӧ	kpv
вырсышкы	mrj
erosioonil	est
шачшывлӓ	mrj
pirukad	est
боровтне	myv
коми-зырян	udm
selitus	est
аняби	kpv
коморозонзо	myv
лесникесь	myv
тадарын	mrj
кулэлыксэ	udm
vektorianalyysin	fin
алюминийстэ	myv
myrkkynuolten	fin
стрӧйбалӧн	kpv
быдтон	udm
танцывлӓ	mrj
керемет	mrj
потребительяслӧн	kpv
кузт	myv
тангата	mrj
зӧлӧта	kpv
sotarikollisia	fin
тундраын	udm
иганъяс	kpv
акка	kpv
desimetriaalloilla	fin
sünnist	est
fantoomi	est
konsonantsi	est
вордсконэз	udm
блокадаын	udm
сёлмосонзо	myv
омӧльтор	kpv
funktsionääri	est
юöрпас	kpv
laboratoriotutkimus	fin
геометриез	udm
tadžiki	est
tok-pisinillä	fin
честь	mrj
сапонь	myv
агроном	mrj
илёвт	myv
лексикалӧн	kpv
барышень	myv
ajendil	est
bay	kpv
услоест	myv
eksegetiikkaan	fin
программа	myv
шишкыш	mrj
танке	udm
восстание	udm
уголиясо	myv
лорка	mrj
kantorina	est
метеор	mrj
реестр	kpv
палымодань	myv
эрексия	myv
naaskel	est
турунчӧжъясыс	kpv
рецензиштӹ	mrj
дёшоват	myv
vesibussiksi	fin
pealekandmise	est
кузнеч	kpv
тоннаысь	kpv
телефильмань	myv
скалой	myv
allumatus	est
рисьминеть	myv
kitkakertoimille	fin
кедр	mrj
utopistid	est
йогывлӓштӹ	mrj
электрон	kpv
фокусникесь	myv
sedelitele	est
viskaja	est
поэтӹн	mrj
маршрут	myv
sisähalkaisija	fin
экземпляръёс	udm
tõmblukuga	est
колониякс	myv
полö	kpv
esperantistidest	est
коръясыс	kpv
сӧдз	kpv
шаньлун	kpv
шаркан	myv
дуре	udm
hüpertroofiat	est
ведьбайге	myv
оз	kpv
этапыс	kpv
амбулатория	udm
бызара	udm
mõistujutt	est
тенниссэ	myv
asikkalalaisia	fin
ивашка	myv
kuivaniemeläiset	fin
пост	kpv
пряничкат	myv
пазьгон	udm
ӧлицӓштӹ	mrj
семьи	mrj
чилим	kpv
википедишкӹ	mrj
ситцасто	myv
titraus	fin
гӧгӧрвотӧмторсӧ	kpv
известь	myv
ноябрь	mrj
teadvuseta	est
баклан	mrj
asuu	est
вугыр	kpv
vesinikuna	est
gastrollid	est
взводӧн	kpv
asianhaarojen	fin
alamalseisva	est
функцижӹм	mrj
мӧрвлӓ	mrj
тутко	myv
sülemlemist	est
миграциос	udm
раскас	kpv
кальчанава	myv
integreerumine	est
вузын	kpv
шоныдыс	kpv
прававлӓжӹн	mrj
bostonit	est
массань	myv
заливлысь	kpv
детинка	kpv
глас	kpv
пистолетысь	kpv
кинотеатръёс	udm
partitiiv	est
цӓр	mrj
ваньмыз-ӧвӧлэз	udm
шудэ	udm
mürgistuste	est
ковержым	mrj
пушнер	udm
фаунасто	myv
муш	mrj
torjuntataistelujen	fin
nimitystään	fin
vedonlyönnit	fin
кшуманця	myv
вöлтарын	kpv
seljaga	est
ссылкае	udm
дачась	myv
муош	kpv
цуня	mrj
анатомижӹ	mrj
воргоронлэсь	udm
авиациысь	udm
проектъёссыя	udm
ӹжӓлжӹ	mrj
isolumikon	fin
пикш	mrj
kestomuisti	fin
falsetiks	est
frikadellid	est
antologisti	fin
пункт	mrj
kellusid	est
kiitmine	est
малахай	mrj
под	kpv
спортышты	mrj
rohtojen	fin
сӥлез	udm
loidus	est
ныв-писянь	kpv
työtulojen	fin
ӹштӓлтмӓш	mrj
каворьсэ	myv
мамак	udm
оброк	kpv
kosioretkille	fin
sisäosan	fin
стопкас	myv
лäкмäш	mrj
толмаш	mrj
воздух	myv
произведениосыз	udm
mujahideeneista	fin
fakkel	est
meriantura	fin
mutanteista	fin
кекше	myv
реставратор	mrj
вийнесэ	myv
полициясо	myv
тылванды	mrj
благовещени	mrj
тӹкӹ	mrj
kadotettuja	fin
критери	mrj
lollakaid	est
kiskjatest	est
luentokurssillaan	fin
блок	udm
aseptika	est
liikennerikoksista	fin
сев	myv
полоцкоень	myv
ветеринар	udm
кыянтор	kpv
сёвонев	myv
миллиард	udm
гуринесэ	myv
ladvik	est
йыртэмасьёс	udm
чуваж	myv
eksistentsiga	est
mielenkiintoisuutta	fin
riisling	est
пырмӧсъяс	kpv
hansa	est
пупсематнестэ	myv
loosungitesse	est
ая-пиа	kpv
valtiosihteerikseen	fin
эмъяськон	udm
пыжа	kpv
согласнойтне	myv
ёзмуртэз	udm
орфографиянтень	myv
предмет	mrj
kieliluun	fin
судья	kpv
selostuksensa	fin
тюрьмаш	mrj
вредӓжӹ	mrj
akaasiapuuta	fin
числительной	myv
ногакыв	kpv
susi	est
мырлӧн	kpv
пӧрдшӹголвлӓ	mrj
тӱтӱтвлӓ	mrj
mägismaale	est
avamused	est
kontoriteks	est
витема	myv
критика	udm
sukupuun	fin
assortii	est
inversioonide	est
совхоз	udm
peräevät	fin
суслонгер	myv
gripiks	est
эгоиствлӓ	mrj
pitimiksi	fin
бронза	kpv
ырдӹ	mrj
топографӧн	kpv
аварцым	mrj
vetokoiria	fin
сузэрзэ	udm
аэропортэз	udm
metallurgias	est
религивлäн	mrj
suulistel	est
симпозиумъёсты	udm
ӝужан	udm
tok	kpv
голям	kpv
kõps	est
лисьманть	myv
седейтокномавтомо	myv
губорень	myv
eksistenssistä	fin
рокым	mrj
шӱмемӹн	mrj
diplomatiallaan	fin
morfoloogias	est
бервылъёсын	udm
nurjatused	est
сäвӹм	mrj
krepist	est
тейтерькатне	myv
инязорокс	myv
rypälepommia	fin
августеш	mrj
humoorikust	est
купель	kpv
relaation	fin
kaupunginsihteeri	fin
снарядъёс	udm
судьяослы	udm
harmoonika	est
эжтас	kpv
zooloogias	est
detektorites	est
разряд	udm
россиянть	myv
pihdat	fin
haletsusest	est
счетовод	mrj
забастовкае	udm
акцин	mrj
niint	est
ылнаыс	kpv
бизон	udm
тенденцият	myv
манифестсэ	udm
кристаллнэ	myv
амфибивлӓм	mrj
промодо	myv
portaissa	fin
ченявкс	myv
ammattipoliitikkoja	fin
tulinopeuden	fin
реформаез	udm
утемъёсы	udm
инфузориятне	myv
сундерьгадома	myv
тошнас	myv
lühendis	est
risiiniöljyä	fin
kritiseerimisest	est
яруссо	myv
бамбук	kpv
актёръяслысь	kpv
лӱмäшвлäжӹ	mrj
myötävaikutusta	fin
этнографияысь	kpv
корныгешӹвлӓлӓн	mrj
pulut	fin
журналиствлäн	mrj
rapmusiikista	fin
салазки	udm
kaeras	est
фондысь	kpv
zenbuddhalaisuus	fin
pillike	fin
паёкыс	kpv
тувталтнэнь	myv
углерод	mrj
kuusitoistavuotias	fin
allikmaterjal	est
pajusirkun	fin
керттӥськон	udm
seismiseks	est
нюк	udm
туст	myv
kyynärpäätä	fin
аварозь	myv
ярсыця	myv
антилопа	udm
vihjeid	est
лапавлӓжӹ	mrj
грисбок	udm
hõrgutisi	est
hidaslori	fin
рекомендацияяс	kpv
юдмас	myv
гырке	udm
yleiskunnon	fin
комсомол	mrj
kruntidega	est
vatsaontelonsa	fin
граф	udm
pankrease	est
скипидар	udm
ленинизм	kpv
лама	udm
harhakuvitelmaa	fin
kimmokkeen	fin
ломаннень	myv
флора	myv
паспорт	kpv
vitsauksena	fin
täydentäminen	fin
hüpoteegid	est
лирика	kpv
мардежӹн	mrj
зданижӹ	mrj
общества	myv
kuuliaisuuden	fin
варчамо	myv
kanuunallaan	fin
irakilaisten	fin
gröönlastel	est
kõvasid	est
шӧртньӹн	mrj
имнижӹм	mrj
воргаас	kpv
антропологияя	udm
hävi	est
lainrikkojia	fin
vapaaohjelma	fin
kauppatieteet	fin
ühilduvuse	est
пырись	udm
soppideta	est
учётчик	udm
пӱжвӹдӹм	mrj
гайгемат	myv
лациця	myv
keetes	est
bordellin	fin
карса	kpv
принцлӓн	mrj
дыня	kpv
археологи	udm
паксяёр	myv
ӟенеликъёссэс	udm
визь-кенешен	udm
иллюстрациосты	udm
laivaranta	fin
клад	kpv
веразы	udm
õõnestus	est
ремонт	kpv
понаст	myv
kümmeaastak	est
süngusse	est
события	myv
хлопок	kpv
turneest	est
ruskon	fin
гипотеза	kpv
точка	myv
войнатнесэ	myv
каназорт	myv
ордаяс	kpv
matkaratsastuksessa	fin
кам	kpv
yritystoiminnasta	fin
armatsemise	est
органвлäжӹ	mrj
кулянь	myv
kotelokopan	fin
чунгыр	kpv
rengaslihas	fin
kahvade	est
драматургъёс	udm
pääideologinaan	fin
мычашеш	mrj
молот	udm
соредӓлмӓшвлӓ	mrj
материализм	kpv
hilp	est
taaskasutusega	est
varisemisena	est
kajalokatsiooni	est
субъектӧн	kpv
ohikulkumatkallaan	fin
silkkihansikkain	fin
kääbast	est
плӧтникӧн	kpv
гайгеме	myv
улӥсьёслы	udm
водка	kpv
ёмаяслӧн	kpv
ыр	mrj
muoto-oppia	fin
koulusanakirja	fin
фольклор	myv
berni	est
зёль	kpv
põngerjas	est
radiolähetyksinä	fin
vallalistel	est
mikrofonidest	est
кöкбöрдъяс	kpv
бюровлӓм	mrj
adhesiooni	est
kaunokirjallisuudelle	fin
шӱлӹшӹм	mrj
революциянь	myv
раштамо	myv
гулинеть	myv
pienkarjaansa	fin
seast	est
yllätyshyökkäykseltä	fin
ottelurangaistukset	fin
säilitist	est
harulduse	est
järjestäytymisvapaus	fin
латкинентень	myv
kohalt	est
udmurtia	est
сакалов	myv
кум	udm
вар	myv
чех	udm
пузырнень	myv
администраци	udm
кудосо	myv
кинофильмез	udm
omikron	fin
сунисъясысь	kpv
сантиметр	mrj
коалициштӹ	mrj
детальёс	udm
озяскеть	myv
дидактикань	myv
novat	fin
äänikynnysten	fin
швеция	myv
israelilaisina	fin
суахили	udm
адрес	myv
lehti-ilmoituksillaan	fin
kohandamises	est
ӹнгӹж	mrj
ортчем	udm
этногенеззылы	udm
шот	mrj
karvattomuuteen	fin
пынын	mrj
штурманонь	myv
венок	mrj
kalatiet	fin
сепанды	mrj
вуджӧдчысьӧн	kpv
кородомат	myv
виолончельлӓн	mrj
monoliidiga	est
карта	mrj
pantsid	est
гимнэзлэсь	udm
пасьтала	kpv
merirokot	fin
villiminkki	fin
harjust	est
буй	udm
meltsa	est
seldžukkeja	fin
равенствосö	kpv
эпистефиум	udm
кинас	kpv
велосипедным	kpv
финансируйымашым	mrj
еврейвлӓн	mrj
мечта	kpv
daugava	est
лапатаэм	mrj
käivitus	est
vihinat	est
трескавлӓ	mrj
итӹрӓйӹмӓш	mrj
цуцалан	mrj
телефононь	myv
мастер	udm
кочеркӓм	mrj
buda	est
мамыслöн	kpv
блокада	kpv
дополнени	mrj
литературовед	udm
шоссе	mrj
jalkamiehen	fin
пустачей	myv
возьматӥсь	udm
можжевельник	myv
puhmastikest	est
эстонецъёс	udm
каштмолема	myv
драматургонть	myv
дерьгун	myv
lepoasentoonsa	fin
варминесь	myv
превензэ	myv
филологим	mrj
са	kpv
вяткаез	udm
jaheduse	est
редколлегиянь	myv
линиядо	myv
кураськисез	udm
viinamäki	fin
нимберд	kpv
кытлaн	mrj
brasilialainen	fin
схемаез	udm
седӹрӓ	mrj
мешамо	myv
менельстэ	myv
парашют	mrj
paa	est
palukesi	est
kissanpennun	fin
чинязось	myv
публицистика	myv
нилькс	myv
katkonaisuutta	fin
коньдонзэс	udm
театре	udm
мӧскӓвӹлӹш	mrj
лымы	udm
кисельöн	kpv
tööliskond	est
коськъяс	kpv
стройсӧ	kpv
часиясь	myv
saumauksen	fin
титулъёссы	udm
sämpylää	fin
критикъёс	udm
куншкакуронь	myv
ведьпарсейть	myv
русской	myv
черепъяс	kpv
myrkkysyöteillä	fin
пиньтурын	udm
механика	kpv
satanismi	est
oomegaan	fin
консультацияяс	kpv
коронаен	udm
субъекттнэ	myv
lamblioosi	est
tuulitunnelin	fin
rinnastamista	fin
сультесь	myv
пинькай	kpv
муюгыд	kpv
вотякъёслэсь	udm
сменаӧ	kpv
harvennusta	fin
сказитель	myv
pultruusiossa	fin
relativismille	fin
биология	myv
кöрымсö	kpv
ofo	fin
артыцянть	myv
цӓцӓля	mrj
liuottimia	fin
магистральлэн	udm
чувашъёслэн	udm
баб	kpv
выльторйӧн	kpv
reservatsioonis	est
надобият	myv
цӹкмӓлан	mrj
дзиб	kpv
afro	fin
oksistoon	fin
консульство	mrj
ученыйвлäн	mrj
клубъясын	kpv
чаравтома	myv
vabastus	est
kaotamiseni	est
потон	udm
пор	myv
tammivyöhykkeestä	fin
feetus	est
pohjaväri	fin
участковый	mrj
küti	est
климатын	udm
воскресенье	udm
урвач	mrj
кушинъяс	kpv
oktetile	est
vaivaishiiriä	fin
arkebuus	est
месайыс	kpv
паром	kpv
алтыця	myv
олимпиада	kpv
этаж	mrj
kultuurituse	est
ной	kpv
толкун	myv
викшневкст	myv
пургондавксонзо	myv
гармонистӹштӹ	mrj
säätötekniikassa	fin
kaariminuutti	fin
резервъяс	kpv
союз	udm
subretina	est
tyylilajia	fin
öljylöydöstä	fin
январ	kpv
põlemine	est
simsille	fin
биолог	kpv
академикез	udm
письыс	kpv
лия	udm
электромеханикая	udm
киви	mrj
lauljannat	est
maltoosia	fin
алашине	myv
катшаяс	kpv
rojalistien	fin
таргоюткот	myv
докладын	kpv
лейожась	myv
чабак	udm
флора	udm
pistetilanne	fin
valgustusega	est
мукӧдтор	kpv
козырев	myv
musket	est
make-up	fin
украинецэнь	myv
lar	kpv
kõleduse	est
metanolille	fin
подвиг	udm
фарфор	kpv
антологиоссэ	udm
кäпвлä	mrj
вошъян	udm
kollektsionääri	est
магистр	udm
supler	est
тиф	udm
newfoundlandi	est
эм	kpv
летькень	myv
sovintopolitiikkaa	fin
кольӧма	kpv
философ	udm
эмиграциясо	myv
мещана	kpv
karvari	fin
peolised	est
ydinsukellusvene	fin
апрель	myv
lagipea	est
промышленносьт	kpv
huulikul	est
hakemisto	fin
tempuissaan	fin
кварталысь	udm
дуэ	udm
imukaloihin	fin
селмаш	mrj
амбулатори	mrj
пöжассö	kpv
рытыввыв	kpv
sak	kpv
сёйöд	kpv
mutakylvyt	fin
магнит	kpv
клевер	mrj
топонимесь	myv
русла	myv
nuutri	est
баян	kpv
правосуди	mrj
горькоень	myv
заявление	kpv
карманым	mrj
каналъясті	kpv
võitmatute	est
вертолёт	kpv
ыштон	udm
слава	kpv
аварькай	myv
radiosovituksia	fin
särkkiä	fin
võitmatusse	est
tuulipölytyksen	fin
лаз	kpv
дӧва	kpv
плутон	kpv
нардеть	myv
stiimulitele	est
tulopolitiikkaa	fin
катша-ракалысь	kpv
provintslikkus	est
laskettelijoita	fin
rintaneulat	fin
пружина	mrj
мобилизация	kpv
колхозниквлӓ	mrj
мазычисэ	myv
телӹм	mrj
шӹведӹлмӓшвлӓм	mrj
шаргаш	mrj
телепередача	udm
нолгы	mrj
пелькстыцянть	myv
философиянь	myv
reunamoreeneja	fin
пилемъёслэсь	udm
дыр	kpv
пичинеть	myv
химия	kpv
делӧ	kpv
важодицякс	myv
тодметъёс	udm
seulaksi	fin
практикаын	udm
palvusest	est
кышнояськемын	udm
kasuistikata	est
журналвлӓэш	mrj
полкын	mrj
уалалан	mrj
миграциос	udm
папивлӓнӓ	mrj
pyöryköiden	fin
abessiiv	est
infiks	est
грузинэнь	myv
тякинесь	myv
ehtoollispöytä	fin
парад	myv
казямот	myv
hiilakas	est
земство	mrj
ел	myv
кыдз	kpv
пыдӧс	kpv
ёрот	myv
piigast	est
пуражы	mrj
palkinnonsaajia	fin
юкöдув	kpv
ilmaisjakelulehti	fin
сёнсянь	kpv
шпион	mrj
чумондомась	myv
миндаль	mrj
membraani	fin
эрикс	myv
текстъяс	kpv
мугез	udm
кужинес	myv
меньшевик	myv
märgendiga	est
городэз	udm
kiivauden	fin
kangasrouskulla	fin
берлань	udm
серем	udm
etelänbastardikilpikonna	fin
toonikumi	est
солистка	myv
муеманть	myv
сӹнгӹмӓшӹн	mrj
eebenipuust	est
egoismi	est
плетень	myv
чей	myv
призма	mrj
медкӧдзыдін	kpv
крючоксо	myv
merenkulkua	fin
комына	kpv
anekaupan	fin
толбарго	myv
